O.S.N.,Candidate,Party,EVM Votes,Postal Votes,Total Votes,% of Votes,Constituency
1,A K M Ashraf,Indian Union Muslim League,65190,568,65758,38.14,Manjeshwar
2,V V Rameshan,Communist Party of India (Marxist),40098,541,40639,23.57,Manjeshwar
3,K Surendran,Bharatiya Janata Party,64000,1013,65013,37.7,Manjeshwar
4,Praveen Kumar S,Anna Democratic Human Rights Movement Party of India,250,1,251,0.15,Manjeshwar
5,John D Souza I,Independent,180,1,181,0.1,Manjeshwar
6,Surendran M S/O Padmavathi M,Independent,196,1,197,0.11,Manjeshwar
7,Nota,None of the Above,387,0,387,0.22,Manjeshwar
1,N A Nellikkunnu,Indian Union Muslim League,62824,472,63296,43.8,Kasaragod
2,Vijaya K P,Bahujan Samaj Party,664,15,679,0.47,Kasaragod
3,Adv K Shreekanth,Bharatiya Janata Party,49737,658,50395,34.88,Kasaragod
4,Ranjith Raj M,Anna Democratic Human Rights Movement Party of India,545,10,555,0.38,Kasaragod
5,M A Latheef,Indian National League,28028,295,28323,19.6,Kasaragod
6,Nishanth Kumar I B,Independent,412,5,417,0.29,Kasaragod
7,Sudhakaran K,Independent,192,4,196,0.14,Kasaragod
8,Nota,None of the Above,629,10,639,0.44,Kasaragod
1,C H Kunhambu,Communist Party of India (Marxist),76733,1931,78664,47.58,Udma
2,Balakrishnan Periye,Indian National Congress,64117,1225,65342,39.52,Udma
3,A Velayudhan,Bharatiya Janata Party,19978,382,20360,12.31,Udma
4,Govindan B Alinthaze,Ambedkarite Party of India,189,5,194,0.12,Udma
5,Kunhambu K S/O Kuttappan K C,Independent,134,6,140,0.08,Udma
6,Rameshan K,Independent,204,3,207,0.13,Udma
7,Nota,None of the Above,430,4,434,0.26,Udma
1,E Chandrashekaran,Communist Party of India,82189,2426,84615,50.72,Kanhangad
2,Balraj,Bharatiya Janata Party,21119,451,21570,12.93,Kanhangad
3,P V Suresh,Indian National Congress,56112,1364,57476,34.45,Kanhangad
4,Abdul Samad. T S/O T Kunhamu Haji,SOCIAL DEMOCRATIC PARTY OF INDIA,774,1,775,0.46,Kanhangad
5,T Abdul Samad S/O T Kunhikoya Haji,Janata Dal (United),86,1,87,0.05,Kanhangad
6,Reshma Karivedakam,Anna Democratic Human Rights Movement Party of India,181,4,185,0.11,Kanhangad
7,Augustin,Independent,495,37,532,0.32,Kanhangad
8,Krishnan Parappachal,Independent,347,10,357,0.21,Kanhangad
9,Manoj Thomas,Independent,93,12,105,0.06,Kanhangad
10,Sreenath Sasi. T C V,Independent,218,1,219,0.13,Kanhangad
11,Suresh. B C S/O Cheniyan Naik,Independent,276,1,277,0.17,Kanhangad
12,Nota,None of the Above,620,17,637,0.38,Kanhangad
1,M Rajagopalan,Communist Party of India (Marxist),82556,3595,86151,53.71,Trikaripur
2,Shibin T V,Bharatiya Janata Party,10621,340,10961,6.83,Trikaripur
3,M P Joseph,Kerala Congress,58200,1814,60014,37.41,Trikaripur
4,T Mahesh Master,Welfare Party Of India,799,18,817,0.51,Trikaripur
5,Liyakathali P,SOCIAL DEMOCRATIC PARTY OF INDIA,1188,23,1211,0.75,Trikaripur
6,Sudhan Vellarikkund,Anna Democratic Human Rights Movement Party of India,104,12,116,0.07,Trikaripur
7,Joy John,Independent,352,10,362,0.23,Trikaripur
8,M V Joseph,Independent,192,26,218,0.14,Trikaripur
9,Nota,None of the Above,521,37,558,0.35,Trikaripur
1,M Pradeep Kumar,Indian National Congress,42723,1192,43915,29.29,Payyannur
2,T I Madhusoodanan,Communist Party of India (Marxist),89909,3786,93695,62.49,Payyannur
3,Adv K K Sreedharan,Bharatiya Janata Party,11048,260,11308,7.54,Payyannur
4,Abhilash K V,Independent,334,7,341,0.23,Payyannur
5,Nota,None of the Above,653,33,686,0.46,Payyannur
1,Arun Kaithapram,Bharatiya Janata Party,11135,230,11365,7.81,Kalliasseri
2,Adv. Brijesh Kumar,Indian National Congress,42785,1074,43859,30.13,Kalliasseri
3,M Vijin,Communist Party of India (Marxist),85304,2948,88252,60.62,Kalliasseri
4,Faizal Madayi,Welfare Party Of India,1141,28,1169,0.8,Kalliasseri
5,Brijeshkumar M. S/O Ambu,Independent,272,2,274,0.19,Kalliasseri
6,Nota,None of the Above,647,19,666,0.46,Kalliasseri
1,M V Govindan Master,Communist Party of India (Marxist),89248,3622,92870,52.14,Taliparamba
2,A P Gangadharan,Bharatiya Janata Party,12737,321,13058,7.33,Taliparamba
3,Adv. V P Abdul Rasheed,Indian National Congress,68539,1642,70181,39.4,Taliparamba
4,Abdul Rasheed S/O Ismail,Independent,364,1,365,0.2,Taliparamba
5,Govindan Karayapath,Independent,138,12,150,0.08,Taliparamba
6,C Balakrishnan Yadav,Independent,186,5,191,0.11,Taliparamba
7,Shijith K O P,Independent,497,11,508,0.29,Taliparamba
8,Nota,None of the Above,773,16,789,0.44,Taliparamba
1,Aniamma Teacher,Bharatiya Janata Party,7608,217,7825,5.13,Irikkur
2,Saji Kuttiyanimattam,Kerala Congress (M),64467,2287,66754,43.77,Irikkur
3,Adv. Sajeev Joseph,Indian National Congress,74194,2570,76764,50.33,Irikkur
4,Chacko Karimbil,Independent,295,16,311,0.2,Irikkur
5,Joy John,Independent,123,5,128,0.08,Irikkur
6,Sajan Kuttiyanikkal,Independent,268,7,275,0.18,Irikkur
7,Nota,None of the Above,449,10,459,0.3,Irikkur
1,K Ranjith,Bharatiya Janata Party,15403,338,15741,10.86,Azhikode
2,K M Shaji,Indian Union Muslim League,58490,1163,59653,41.17,Azhikode
3,K V Sumesh,Communist Party of India (Marxist),63895,1899,65794,45.41,Azhikode
4,Abdul Jabbar K K,SOCIAL DEMOCRATIC PARTY OF INDIA,2348,9,2357,1.63,Azhikode
5,Resmi Ravi,SOCIALIST UNITY CENTRE OF INDIA (COMMUNIST),224,2,226,0.16,Azhikode
6,Pavithran Kurikkalot,Independent,41,7,48,0.03,Azhikode
7,Prasad V P,Independent,96,8,104,0.07,Azhikode
8,K M Shaji (Mamba),Independent,256,21,277,0.19,Azhikode
9,Sumesh M (Mauvery House),Independent,177,3,180,0.12,Azhikode
10,Nota,None of the Above,503,14,517,0.36,Azhikode
1,Archana Vandichal,Bharatiya Janata Party,11340,241,11581,8.64,Kannur
2,Satheeshan Pacheni,Indian National Congress,56953,1615,58568,43.68,Kannur
3,T K Ganesh Babu,New Labour Party,709,7,716,0.53,Kannur
4,Ramachandran Kadannappalli,Congress (Secular),58505,1808,60313,44.98,Kannur
5,B Shamsudheen Moulavi,SOCIAL DEMOCRATIC PARTY OF INDIA,2061,8,2069,1.54,Kannur
6,Ramachandran P V,Independent,106,1,107,0.08,Kannur
7,Satheesan P,Independent,134,13,147,0.11,Kannur
8,N K Surendran,Independent,83,1,84,0.06,Kannur
9,Nota,None of the Above,475,29,504,0.38,Kannur
1,C. K. Padmanabhan,Bharatiya Janata Party,14352,271,14623,9.13,Dharmadam
2,Pinarayi Vijayan,Communist Party of India (Marxist),92140,3382,95522,59.61,Dharmadam
3,C. Raghunathan,Indian National Congress,44089,1310,45399,28.33,Dharmadam
4,Basheer Kannadiparamba,SOCIAL DEMOCRATIC PARTY OF INDIA,2266,14,2280,1.42,Dharmadam
5,Chovva Raghunathan,Independent,136,1,137,0.09,Dharmadam
6,Valayar Bhagyavathi,Independent,1720,33,1753,1.09,Dharmadam
7,C. P. Maharoof,Independent,66,6,72,0.04,Dharmadam
8,Vadi Harindran,Independent,53,8,61,0.04,Dharmadam
9,Nota,None of the Above,390,10,400,0.25,Dharmadam
1,M. P. Aravindakshan,Indian National Congress,43811,1198,45009,33.84,Thalassery
2,Adv. A. N. Shamseer,Communist Party of India (Marxist),79628,2182,81810,61.52,Thalassery
3,Shamseer Ibrahim,Welfare Party Of India,1945,18,1963,1.48,Thalassery
4,Aravindhakshan S/O Kausu,Independent,522,11,533,0.4,Thalassery
5,C. O. T. Naseer,Independent,1127,36,1163,0.87,Thalassery
6,Haridasan,Independent,189,9,198,0.15,Thalassery
7,Nota,None of the Above,2283,30,2313,1.74,Thalassery
1,Pottankandi Abdulla,Indian Union Muslim League,59720,1365,61085,39.23,Kuthuparamba
2,C. Sadanandan Master,Bharatiya Janata Party,20795,417,21212,13.62,Kuthuparamba
3,K.P. Mohanan,Loktantrik Janta Dal,68472,2154,70626,45.36,Kuthuparamba
4,Abdulla Puthiyaparambath,Independent,379,10,389,0.25,Kuthuparamba
5,Mohanan Kunhiparambath Meethal,Independent,1334,26,1360,0.87,Kuthuparamba
6,Mohanan K.P. Kaithavecha Parambath,Independent,515,28,543,0.35,Kuthuparamba
7,Nota,None of the Above,489,5,494,0.32,Kuthuparamba
1,Illikkal Augusthy,Revolutionary Socialist Party,34195,971,35166,22.67,Mattannur
2,Biju Elakkuzhi,Bharatiya Janata Party,17815,408,18223,11.75,Mattannur
3,K K Shailaja Teacher,Communist Party of India (Marxist),93007,3122,96129,61.97,Mattannur
4,Rafeek Keechery,SOCIAL DEMOCRATIC PARTY OF INDIA,4173,28,4201,2.71,Mattannur
5,Agusthy N A,Independent,603,16,619,0.4,Mattannur
6,Nota,None of the Above,781,15,796,0.51,Mattannur
1,K V Sakkeer Hussain,Communist Party of India (Marxist),61942,1592,63534,44.7,Peravoor
2,Adv. Sunny Joseph,Indian National Congress,64784,1922,66706,46.93,Peravoor
3,Smitha Jayamohan,Bharatiya Janata Party,8956,199,9155,6.44,Peravoor
4,A C Jalaluddeen,SOCIAL DEMOCRATIC PARTY OF INDIA,1530,11,1541,1.08,Peravoor
5,John Pallikkamalil,Secular Democratic Congress,88,4,92,0.06,Peravoor
6,P K Saji,New Labour Party,104,2,106,0.07,Peravoor
7,Narayanakumar,Independent,55,5,60,0.04,Peravoor
8,Sakkeer E K S/O Asiya,Independent,101,15,116,0.08,Peravoor
9,Sakkeer Hussain S/O Hamsa,Independent,240,3,243,0.17,Peravoor
10,Sunny Muthukulathel,Independent,60,0,60,0.04,Peravoor
11,Sunny Vazhakkamalayil,Independent,121,0,121,0.09,Peravoor
12,Nota,None of the Above,392,12,404,0.28,Peravoor
1,O.R.Kelu,Communist Party of India (Marxist),70807,1729,72536,47.54,Mananthavady
2,P.K.Jayalakshmi,Indian National Congress,61741,1513,63254,41.46,Mananthavady
3,Palliyara Mukundan,Bharatiya Janata Party,12911,231,13142,8.61,Mananthavady
4,Vijaya Cheloor,Bahujan Samaj Party,188,2,190,0.12,Mananthavady
5,Babitha Sreenu,SOCIAL DEMOCRATIC PARTY OF INDIA,1966,26,1992,1.31,Mananthavady
6,Kelu K.K. S/O Kunkan,Independent,274,14,288,0.19,Mananthavady
7,Lakshmi,Independent,374,8,382,0.25,Mananthavady
8,Nota,None of the Above,792,5,797,0.52,Mananthavady
1,C.K Janu,Bharatiya Janata Party,14934,264,15198,9.08,Sulthanbathery
2,I.C Balakrishnan,Indian National Congress,79152,1925,81077,48.42,Sulthanbathery
3,M.S Viswanathan,Communist Party of India (Marxist),67616,1639,69255,41.36,Sulthanbathery
4,Ondan Paniyan,Independent,730,12,742,0.44,Sulthanbathery
5,Nota,None of the Above,1142,18,1160,0.69,Sulthanbathery
1,Aswin Bhimnath,Bahujan Samaj Party,915,13,928,0.61,Kalpetta
2,Adv.T Siddiqu,Indian National Congress,68845,1407,70252,46.15,Kalpetta
3,Subeesh T M,Bharatiya Janata Party,13868,245,14113,9.27,Kalpetta
4,M.V.Shreyamskumar,Loktantrik Janta Dal,63392,1390,64782,42.56,Kalpetta
5,Sunil Vaidyar,Anna Democratic Human Rights Movement Party of India,444,11,455,0.3,Kalpetta
6,Shylesh.K,Independent,204,6,210,0.14,Kalpetta
7,T.Sidique S/O Abdulla,Independent,634,7,641,0.42,Kalpetta
8,Nota,None of the Above,809,19,828,0.54,Kalpetta
1,Advocate M. Rajesh Kumar,Bharatiya Janata Party,10033,192,10225,7.48,Vadakara
2,Manayath Chandran,Loktantrik Janta Dal,55672,1930,57602,42.15,Vadakara
3,Musthafa Paleri,SOCIAL DEMOCRATIC PARTY OF INDIA,2820,16,2836,2.08,Vadakara
4,K.K.Rema,Revolutionary Marxist Party of India,63418,1675,65093,47.63,Vadakara
5,Gangadharan Madappally,Independent,182,4,186,0.14,Vadakara
6,Velluparambath Chandran,Independent,60,3,63,0.05,Vadakara
7,Rama Kuniyil,Independent,112,14,126,0.09,Vadakara
8,Rama Cheriya Kayyil,Independent,50,2,52,0.04,Vadakara
9,K.T.K Rama Padannayil,Independent,128,9,137,0.1,Vadakara
10,Nota,None of the Above,347,6,353,0.26,Vadakara
1,K P Kunhammed Kutti Master,Communist Party of India (Marxist),77265,2878,80143,47.2,Kuttiadi
2,Parakkal Abdulla,Indian Union Muslim League,77561,2249,79810,47.01,Kuttiadi
3,P P Murali Master,Bharatiya Janata Party,8919,220,9139,5.38,Kuttiadi
4,Abdulla S/O Pokker,Independent,75,0,75,0.04,Kuttiadi
5,K K Kunhammad Kutty,Independent,70,10,80,0.05,Kuttiadi
6,V P Pratheesh,Independent,103,5,108,0.06,Kuttiadi
7,Suresh Babu M K,Independent,125,3,128,0.08,Kuttiadi
8,Nota,None of the Above,282,14,296,0.17,Kuttiadi
1,Adv. K. Praveen Kumar,Indian National Congress,77103,2155,79258,45.16,Nadapuram
2,M. P. Rajan,Bharatiya Janata Party,10320,217,10537,6,Nadapuram
3,E. K. Vijayan,Communist Party of India,80571,2722,83293,47.46,Nadapuram
4,K. K. Nasar Master,SOCIAL DEMOCRATIC PARTY OF INDIA,1654,22,1676,0.95,Nadapuram
5,Sreedharan K K,National Labour Party,163,2,165,0.09,Nadapuram
6,T.Praveen Kumar S/O Kannan,Independent,256,2,258,0.15,Nadapuram
7,Nota,None of the Above,307,9,316,0.18,Nadapuram
1,Kanathil Jameela,Communist Party of India (Marxist),73406,2222,75628,46.66,Quilandy
2,N.P. Radhakrishnan,Bharatiya Janata Party,17213,342,17555,10.83,Quilandy
3,N. Subramaniyan,Indian National Congress,65807,1349,67156,41.43,Quilandy
4,Praveen Cheruvath,SOCIALIST UNITY CENTRE OF INDIA (COMMUNIST),221,0,221,0.14,Quilandy
5,Jameela. P.P.,Independent,646,5,651,0.4,Quilandy
6,Subrahmanyan Kanaran,Independent,380,1,381,0.24,Quilandy
7,Nota,None of the Above,482,10,492,0.3,Quilandy
1,T.P. Ramakrishnan,Communist Party of India (Marxist),82691,3332,86023,52.54,Perambra
2,Adv. K V Sudheer,Bharatiya Janata Party,10834,331,11165,6.82,Perambra
3,Ismail Kammana,SOCIAL DEMOCRATIC PARTY OF INDIA,1441,24,1465,0.89,Perambra
4,C H Ebrahimkutty S/O Kunjammed,Independent,61530,1901,63431,38.74,Perambra
5,Ibrahimkutty M S/O Pokker,Independent,900,15,915,0.56,Perambra
6,V K Chandran,Independent,275,5,280,0.17,Perambra
7,Nota,None of the Above,449,9,458,0.28,Perambra
1,Jobish Balussery,Bahujan Samaj Party,465,11,476,0.26,Balusseri
2,Dharmajan Bolgatty,Indian National Congress,69145,2322,71467,39.28,Balusseri
3,Libin Balussery,Bharatiya Janata Party,16033,457,16490,9.06,Balusseri
4,Adv. K.M. Sachindev,Communist Party of India (Marxist),88612,3227,91839,50.47,Balusseri
5,Chandrika,Welfare Party Of India,856,33,889,0.49,Balusseri
6,Mohandas Unnikulam,Republican Party of India (A),109,6,115,0.06,Balusseri
7,Dharmendran,Independent,235,12,247,0.14,Balusseri
8,Nota,None of the Above,397,34,431,0.24,Balusseri
1,T P Jayachandran Master,Bharatiya Janata Party,31056,954,32010,19.48,Elathur
2,A .K Saseendran,Nationalist Congress Party,80607,3032,83639,50.89,Elathur
3,Tahir Mokkandi,Welfare Party Of India,1911,89,2000,1.22,Elathur
4,Radhakrishnan P K,Independent,548,32,580,0.35,Elathur
5,Sulphikar Mayoori,Independent,43621,1516,45137,27.46,Elathur
6,Nota,None of the Above,960,24,984,0.6,Elathur
1,K M Abhijith,Indian National Congress,44759,1437,46196,33.58,Kozhikode North
2,M T Ramesh,Bharatiya Janata Party,30241,711,30952,22.5,Kozhikode North
3,Thottathil Ravindran,Communist Party of India (Marxist),57357,1767,59124,42.98,Kozhikode North
4,K Rahim,SOCIALIST UNITY CENTRE OF INDIA (COMMUNIST),152,4,156,0.11,Kozhikode North
5,N Abhijith,Independent,328,0,328,0.24,Kozhikode North
6,V P Ramesh,Independent,84,12,96,0.07,Kozhikode North
7,A Ramesh,Independent,94,10,104,0.08,Kozhikode North
8,Urandiyil Raveendran,Independent,75,15,90,0.07,Kozhikode North
9,Nota,None of the Above,513,3,516,0.38,Kozhikode North
1,Navya Haridas,Bharatiya Janata Party,24314,559,24873,20.89,Kozhikode South
2,Adv. Noorbeena Rasheed,Indian Union Muslim League,39393,705,40098,33.68,Kozhikode South
3,Ahammad Devarkovil,Indian National League,51582,975,52557,44.15,Kozhikode South
4,P. Hareendranath,Democratic Social Justice Party,392,18,410,0.34,Kozhikode South
5,Adv. Mubeena,Independent,503,10,513,0.43,Kozhikode South
6,Nota,None of the Above,585,18,603,0.51,Kozhikode South
1,Abdul Gafoor K. K,Bahujan Samaj Party,269,3,272,0.16,Beypore
2,Adv. P. M Niyas,Indian National Congress,52579,839,53418,32.33,Beypore
3,Adv. Prakashbabu,Bharatiya Janata Party,25822,445,26267,15.9,Beypore
4,Adv. P. A Mohamed Riyas,Communist Party of India (Marxist),80505,1660,82165,49.73,Beypore
5,Jamal Chaliyam,SOCIAL DEMOCRATIC PARTY OF INDIA,2015,14,2029,1.23,Beypore
6,E.M Niyas S/O Saleem Babu,Independent,159,3,162,0.1,Beypore
7,Niyas K S/O Koya Kuniyil,Independent,106,5,111,0.07,Beypore
8,P. P Muhammad Riyas S/O Mamukkoya,Independent,160,5,165,0.1,Beypore
9,Nota,None of the Above,601,20,621,0.38,Beypore
1,Adv: V.K. Sajeevan,Bharatiya Janata Party,27048,624,27672,14.28,Kunnamangalam
2,E. P. Anwar Sadath,Welfare Party Of India,1026,31,1057,0.55,Kunnamangalam
3,Abdul Vahid,SOCIAL DEMOCRATIC PARTY OF INDIA,1276,23,1299,0.67,Kunnamangalam
4,Abdul Raheem P S/O. Abdul Kareem,Independent,210,12,222,0.11,Kunnamangalam
5,Abdul Raheem S/O. Hassan Koya,Independent,725,13,738,0.38,Kunnamangalam
6,Dinesh Perumanna,Independent,72998,1864,74862,38.62,Kunnamangalam
7,Dineshan Pakkath,Independent,972,49,1021,0.53,Kunnamangalam
8,Dinesan Mundakkal,Independent,222,3,225,0.12,Kunnamangalam
9,Babu K G,Independent,715,9,724,0.37,Kunnamangalam
10,Adv. P. T. A Rahim,Independent,82498,2640,85138,43.93,Kunnamangalam
11,Nota,None of the Above,851,13,864,0.45,Kunnamangalam
1,T Balasoman,Bharatiya Janata Party,9227,271,9498,6.28,Koduvally
2,Dr. M.K Muneer,Indian Union Muslim League,70193,2143,72336,47.86,Koduvally
3,Musthafa Kommeri,SOCIAL DEMOCRATIC PARTY OF INDIA,1734,35,1769,1.17,Koduvally
4,Shahin K C,Samajwadi Forward Bloc,69,5,74,0.05,Koduvally
5,Abdul Muneer,Independent,86,0,86,0.06,Koduvally
6,Saleem Nechole,Independent,91,1,92,0.06,Koduvally
7,Abdul Razak K S/O Ahmad Kutty,Independent,379,2,381,0.25,Koduvally
8,Karat Razack,Independent,64114,1878,65992,43.66,Koduvally
9,Abdul Razak S/O Muhammed,Independent,316,9,325,0.22,Koduvally
10,Muneer M.K S/O Muhammed,Independent,207,21,228,0.15,Koduvally
11,Lakshmanan.K.P.Thamarassery,Independent,102,2,104,0.07,Koduvally
12,Nota,None of the Above,265,4,269,0.18,Koduvally
1,C. P. Cheriya Muhammed,Indian Union Muslim League,61469,1755,63224,44.21,Thiruvambady
2,Baby Ambattu,Bharatiya Janata Party,7632,162,7794,5.45,Thiruvambady
3,Linto Joseph,Communist Party of India (Marxist),66017,1850,67867,47.46,Thiruvambady
4,K. P. Cheriya Muhammed S/O Kunhoyi,Independent,1100,21,1121,0.78,Thiruvambady
5,Prof.George Mathew Thottathimyalil,Independent,74,4,78,0.05,Thiruvambady
6,Linto Joseph S/O Sali,Independent,550,29,579,0.4,Thiruvambady
7,Lenilal. T. D.,Independent,78,2,80,0.06,Thiruvambady
8,Sunny. V. Joseph,Independent,1800,47,1847,1.29,Thiruvambady
9,Nota,None of the Above,413,6,419,0.29,Thiruvambady
1,T V Ibrahim,Indian Union Muslim League,81259,1500,82759,50.42,Kondotty
2,Sivadasan T,Bahujan Samaj Party,893,15,908,0.55,Kondotty
3,Sheeba Unnikrishnan,Bharatiya Janata Party,10904,210,11114,6.77,Kondotty
4,Razak Paleri,Welfare Party Of India,2505,74,2579,1.57,Kondotty
5,C V Ibrahim S/O Muhammed,Independent,230,3,233,0.14,Kondotty
6,Kattuparuthy Sulaiman Haji,Independent,64015,1078,65093,39.66,Kondotty
7,Sulaiman Haji,Independent,893,12,905,0.55,Kondotty
8,Nota,None of the Above,552,2,554,0.34,Kondotty
1,Adv. C. Dinesh,Bharatiya Janata Party,6509,174,6683,4.66,Eranad
2,P.K. Basheer,Indian Union Muslim League,75952,2124,78076,54.49,Eranad
3,Velayudhan,Bahujan Samaj Party,1227,20,1247,0.87,Eranad
4,K.T. Abdurahiman,Independent,54218,1312,55530,38.76,Eranad
5,Adv. Sebastian,Independent,1077,23,1100,0.77,Eranad
6,Nota,None of the Above,626,10,636,0.44,Eranad
1,Adv. T. K Ashokkumar,Bharatiya Janata Party,8440,155,8595,4.96,Nilambur
2,Adv: V.V. Prakash,Indian National Congress,76713,1814,78527,45.34,Nilambur
3,Anila Mathew,Indian Christian Secular Party,501,8,509,0.29,Nilambur
4,K. Babu Mani,SOCIAL DEMOCRATIC PARTY OF INDIA,3249,32,3281,1.89,Nilambur
5,P.V. Anvar,Independent,79505,1722,81227,46.9,Nilambur
6,Sajadurahman.C.P,Independent,554,5,559,0.32,Nilambur
7,Nota,None of the Above,499,8,507,0.29,Nilambur
1,A P Anilkumar,Indian National Congress,85776,1639,87415,51.44,Wandoor
2,Midhuna P,Communist Party of India (Marxist),70548,1304,71852,42.28,Wandoor
3,Dr. P C Vijayan,Bharatiya Janata Party,6929,128,7057,4.15,Wandoor
4,Krishnan C,Welfare Party Of India,2843,100,2943,1.73,Wandoor
5,Nota,None of the Above,660,4,664,0.39,Wandoor
1,Nazar Debona,Communist Party of India,62881,1382,64263,40.93,Manjeri
2,P.R. Rasmil Nath,Bharatiya Janata Party,11030,320,11350,7.23,Manjeri
3,Adv. U.A. Latheef,Indian Union Muslim League,77384,1452,78836,50.22,Manjeri
4,Palathingal Aboobacker,Independent,1332,9,1341,0.85,Manjeri
5,Nota,None of the Above,1185,17,1202,0.77,Manjeri
1,Najeeb Kanthapuram,Indian Union Muslim League,75264,1266,76530,46.21,Perinthalmanna
2,Suchithra,Bharatiya Janata Party,7846,175,8021,4.84,Perinthalmanna
3,Adv Abdul Afsal P T,Independent,897,9,906,0.55,Perinthalmanna
4,Najeeb Kutteeri,Independent,822,6,828,0.5,Perinthalmanna
5,Musthafa S/O Muhammed,Independent,469,2,471,0.28,Perinthalmanna
6,Musthafa P K S/O Saidalavi,Independent,738,12,750,0.45,Perinthalmanna
7,Muhammed Musthafa K P,Independent,747,4,751,0.45,Perinthalmanna
8,K P M Musthafa S/O Muhammedali Haji,Independent,75067,1425,76492,46.19,Perinthalmanna
9,Nota,None of the Above,856,11,867,0.52,Perinthalmanna
1,Manjalamkuzhi Ali,Indian Union Muslim League,81273,1958,83231,49.46,Mankada
2,Sajesh Elayil,Bharatiya Janata Party,6469,172,6641,3.95,Mankada
3,Adv. T.K. Rasheedali,Communist Party of India (Marxist),75322,1663,76985,45.75,Mankada
4,Ali S/O Alavi Haji,Independent,193,0,193,0.11,Mankada
5,Ali S/O Musthafa,Independent,345,5,350,0.21,Mankada
6,M.Ali,Independent,81,5,86,0.05,Mankada
7,Rasheedali S/O Mammunni,Independent,168,15,183,0.11,Mankada
8,Nota,None of the Above,590,9,599,0.36,Mankada
1,Paloli Abdurahiman,Communist Party of India (Marxist),56814,1144,57958,35.82,Malappuram
2,P. Ubaidulla,Indian Union Muslim League,91470,1696,93166,57.57,Malappuram
3,Prasobh .T,Bahujan Samaj Party,319,2,321,0.2,Malappuram
4,Areekkad Sethumadhavan,Bharatiya Janata Party,5755,128,5883,3.64,Malappuram
5,E.C. Ayisha,Welfare Party Of India,3090,104,3194,1.97,Malappuram
6,T.K. Bose,SOCIALIST UNITY CENTRE OF INDIA (COMMUNIST),309,0,309,0.19,Malappuram
7,Nota,None of the Above,983,11,994,0.61,Malappuram
1,Keeran,Bahujan Samaj Party,1057,3,1060,0.81,Vengara
2,P.K Kunjhalikutty,Indian Union Muslim League,69283,1098,70381,53.5,Vengara
3,P. Jiji,Communist Party of India (Marxist),39150,635,39785,30.24,Vengara
4,Preman Master,Bharatiya Janata Party,5853,115,5968,4.54,Vengara
5,Anannyahkumari Alex,Democratic Social Justice Party,132,3,135,0.1,Vengara
6,E.K. Kunhahamedkutty Master,Welfare Party Of India,1984,67,2051,1.56,Vengara
7,Adil Abdurahiman Thangal,Independent,124,5,129,0.1,Vengara
8,Sabah Kundupuzhakkal,Independent,11149,106,11255,8.56,Vengara
9,Nota,None of the Above,779,8,787,0.6,Vengara
1,Abdul Hameed Master,Indian Union Muslim League,70342,1481,71823,47.43,Vallikkunnu
2,Peethambaran Palat,Bharatiya Janata Party,19304,549,19853,13.11,Vallikkunnu
3,Sasi Kizhakkan,Bahujan Samaj Party,845,36,881,0.58,Vallikkunnu
4,Prof. A.P. Abdul Vahab,Indian National League,56401,1306,57707,38.11,Vallikkunnu
5,Nota,None of the Above,1141,9,1150,0.76,Vallikkunnu
1,K P A Majeed,Indian Union Muslim League,72579,920,73499,49.74,Tirurangadi
2,Abdul Majeed Panakkal,Bahujan Samaj Party,300,3,303,0.21,Tirurangadi
3,Kalliyath Sathar Haji,Bharatiya Janata Party,8128,186,8314,5.63,Tirurangadi
4,Moosa Jarathingal,Swaraj India,269,5,274,0.19,Tirurangadi
5,Abdurahim Naha,Independent,119,1,120,0.08,Tirurangadi
6,Chandran,Independent,129,3,132,0.09,Tirurangadi
7,Niyas,Independent,480,7,487,0.33,Tirurangadi
8,Niyas Pulikkalakath,Independent,63159,762,63921,43.26,Tirurangadi
9,Nota,None of the Above,715,6,721,0.49,Tirurangadi
1,K.Narayanan Master,Bharatiya Janata Party,10371,219,10590,6.94,Tanur
2,P.K.Firos,Indian Union Muslim League,68810,909,69719,45.7,Tanur
3,Mueenudheen,Bahujan Samaj Party,183,0,183,0.12,Tanur
4,V.Abdurahiman,National Secular Conference,69633,1071,70704,46.34,Tanur
5,Abdurahiman.V S/O Alavi Haji,Independent,177,2,179,0.12,Tanur
6,V.Abdurahiman S/O Kathiyamu,Independent,220,4,224,0.15,Tanur
7,Abdurahiman.V S/O Muhammed,Independent,100,2,102,0.07,Tanur
8,Kunhi Mohamed Muthanikkad Bapputty,Independent,207,6,213,0.14,Tanur
9,Firoz S/O Avarankutty,Independent,72,1,73,0.05,Tanur
10,Firoz S/O Kunhumarakkar,Independent,244,3,247,0.16,Tanur
11,Nota,None of the Above,328,8,336,0.22,Tanur
1,Dr. Abdul Salam M,Bharatiya Janata Party,8933,164,9097,5.33,Tirur
2,Adv. Gafoor P Lillis,Communist Party of India (Marxist),73947,1153,75100,43.98,Tirur
3,Kurukkoli Moideen,Indian Union Muslim League,80906,1408,82314,48.21,Tirur
4,Ashraf,SOCIAL DEMOCRATIC PARTY OF INDIA,2699,13,2712,1.59,Tirur
5,Aboobacker Sidheek,Independent,233,7,240,0.14,Tirur
6,Abdul Gafoor Pulikkal,Independent,68,0,68,0.04,Tirur
7,Abdul Gafoor Valiya Peedikakkal,Independent,33,4,37,0.02,Tirur
8,Abdul Mahroof A.K,Independent,105,6,111,0.07,Tirur
9,Moideen Meenthrathakath,Independent,472,5,477,0.28,Tirur
10,Moideen Valiyakath,Independent,167,2,169,0.1,Tirur
11,Nota,None of the Above,416,1,417,0.24,Tirur
1,Prof. Abid Hussain Thangal,Indian Union Muslim League,80061,1639,81700,51.08,Kottakkal
2,P. P. Ganesan,Bharatiya Janata Party,10556,240,10796,6.75,Kottakkal
3,N. A. Muhammed Kutty (Mammuty),Nationalist Congress Party,63739,1373,65112,40.71,Kottakkal
4,Ayisha,Independent,319,9,328,0.21,Kottakkal
5,Bindhu Devarajan,Independent,477,4,481,0.3,Kottakkal
6,Mohamed Kutty,Independent,662,13,675,0.42,Kottakkal
7,Sainul Abid Thangal,Independent,160,13,173,0.11,Kottakkal
8,Nota,None of the Above,664,4,668,0.42,Kottakkal
1,Firos Kunnamparambil,Indian National Congress,66750,1044,67794,44.77,Thavanur
2,Hassan Chiyanoor,SOCIAL DEMOCRATIC PARTY OF INDIA,1738,9,1747,1.15,Thavanur
3,Ramesh Kottayapurath,Bharath Dharma Jana Sena,9756,158,9914,6.55,Thavanur
4,Dr.K.T.Jaleel,Independent,68935,1423,70358,46.46,Thavanur
5,Jaleel S/O. Muhammad Kutty,Independent,306,2,308,0.2,Thavanur
6,Firos Kunnathparambil,Independent,191,3,194,0.13,Thavanur
7,Firos Nellamkunnath,Independent,75,4,79,0.05,Thavanur
8,Firos Paruvingal,Independent,173,2,175,0.12,Thavanur
9,Mohammed Firos Nurukkuprambil,Independent,148,4,152,0.1,Thavanur
10,Vellarikkat Mohammed Rafi,Independent,220,7,227,0.15,Thavanur
11,Nota,None of the Above,471,7,478,0.32,Thavanur
1,P Nandakumar,Communist Party of India (Marxist),73331,1337,74668,51.35,Ponnani
2,Adv. A.M. Rohith,Indian National Congress,56694,931,57625,39.63,Ponnani
3,Anvar Pazhanji,SOCIAL DEMOCRATIC PARTY OF INDIA,3041,24,3065,2.11,Ponnani
4,Ganesh Vaderi,Welfare Party Of India,1820,43,1863,1.28,Ponnani
5,Subramannian Chunkappallii,Bharath Dharma Jana Sena,7302,117,7419,5.1,Ponnani
6,Adv. Roshith. M.P.,Independent,147,21,168,0.12,Ponnani
7,K Sadanandan,Independent,144,3,147,0.1,Ponnani
8,Nota,None of the Above,462,5,467,0.32,Ponnani
1,V .T Balram,Indian National Congress,65629,1169,66798,43.86,Thrithala
2,Rajagopal Thrithala,Bahujan Samaj Party,326,7,333,0.22,Thrithala
3,M. B Rajesh,Communist Party of India (Marxist),68468,1346,69814,45.84,Thrithala
4,Adv:Sanku T Das,Bharatiya Janata Party,12645,206,12851,8.44,Thrithala
5,Abdul Nazar M K,SOCIAL DEMOCRATIC PARTY OF INDIA,1572,10,1582,1.04,Thrithala
6,Noorudheen E V,Independent,69,1,70,0.05,Thrithala
7,Balaraman K S/O Kunjunni,Independent,49,8,57,0.04,Thrithala
8,T .T Balaraman S/O Krishnan Nair,Independent,42,3,45,0.03,Thrithala
9,Rajesh S/O Raman E,Independent,83,8,91,0.06,Thrithala
10,Sreenivas Kuruppath,Independent,136,0,136,0.09,Thrithala
11,Hussain Thattathazhath,Independent,106,1,107,0.07,Thrithala
12,Nota,None of the Above,422,5,427,0.28,Thrithala
1,Narayanan. T.P,Bahujan Samaj Party,504,13,517,0.34,Pattambi
2,Muhammed Muhassin,Communist Party of India,73761,1550,75311,49.58,Pattambi
3,K.M.Haridas,Bharatiya Janata Party,14231,347,14578,9.6,Pattambi
4,Riyas Mukkoli,Indian National Congress,56480,857,57337,37.74,Pattambi
5,Ameer Ali .S.P,SOCIAL DEMOCRATIC PARTY OF INDIA,2946,29,2975,1.96,Pattambi
6,S. Mujeeb Rehman,Welfare Party Of India,776,25,801,0.53,Pattambi
7,Nota,None of the Above,378,12,390,0.26,Pattambi
1,Ayyappan Kutty. T.C.,Bahujan Samaj Party,875,8,883,0.58,Shornur
2,Firoz Babu.T.H,Indian National Congress,36940,786,37726,24.83,Shornur
3,P. Mammikutty,Communist Party of India (Marxist),72641,1759,74400,48.98,Shornur
4,Sandeep Varier,Bharatiya Janata Party,36317,656,36973,24.34,Shornur
5,Muhammad Musthafa,SOCIAL DEMOCRATIC PARTY OF INDIA,1242,9,1251,0.82,Shornur
6,Nota,None of the Above,668,10,678,0.45,Shornur
1,Adv. K. Premkumar,Communist Party of India (Marxist),72977,1882,74859,46.45,Ottapalam
2,P. Venugopalan,Bharatiya Janata Party,24516,540,25056,15.55,Ottapalam
3,P.P. Sivan,Bahujan Samaj Party,654,18,672,0.42,Ottapalam
4,Doctor P. Sarin,Indian National Congress,58399,1308,59707,37.05,Ottapalam
5,Nota,None of the Above,852,15,867,0.54,Ottapalam
1,Guruvayoorappan P E,Bahujan Samaj Party,1321,30,1351,0.98,Kongad
2,U C Raman,Indian Union Muslim League,40046,616,40662,29.36,Kongad
3,Santhakumari K,Communist Party of India (Marxist),66683,1198,67881,49.01,Kongad
4,Suresh Babu M,Bharatiya Janata Party,27223,438,27661,19.97,Kongad
5,Nota,None of the Above,932,21,953,0.69,Kongad
1,Sivadasan,Bahujan Samaj Party,813,14,827,0.54,Mannarkad
2,Advocate. N. Samsudheen,Indian Union Muslim League,70448,1209,71657,47.11,Mannarkad
3,K. P. Suresh Raj,Communist Party of India,64621,1166,65787,43.25,Mannarkad
4,Agali Naseema P,All India Anna Dravida Munnetra Kazhagam,10282,94,10376,6.82,Mannarkad
5,Ajikumar,Independent,157,2,159,0.1,Mannarkad
6,James Mash,Independent,968,20,988,0.65,Mannarkad
7,Shibu George,Independent,97,4,101,0.07,Mannarkad
8,Shamsuddeen S/O. Yusaf,Independent,184,8,192,0.13,Mannarkad
9,Shamsuddeen S/O. Hamza,Independent,479,32,511,0.34,Mannarkad
10,Suresh,Independent,433,7,440,0.29,Mannarkad
11,Suresh Babu,Independent,303,1,304,0.2,Mannarkad
12,Nota,None of the Above,753,7,760,0.5,Mannarkad
1,S. K. Ananthakrishnan,Indian National Congress,34611,833,35444,21.66,Malampuzha
2,Krishnakumar.C,Bharatiya Janata Party,49301,899,50200,30.68,Malampuzha
3,A. Prabhakaran,Communist Party of India (Marxist),74096,1838,75934,46.41,Malampuzha
4,K.Prasad,SOCIALIST UNITY CENTRE OF INDIA (COMMUNIST),550,5,555,0.34,Malampuzha
5,Abdul Raheem. S,Independent,412,6,418,0.26,Malampuzha
6,Nota,None of the Above,1041,13,1054,0.64,Malampuzha
1,Adv. C.P. Promod,Communist Party of India (Marxist),35622,811,36433,25.64,Palakkad
2,E.T.K. Valsan,Bahujan Samaj Party,348,11,359,0.25,Palakkad
3,E. Sreedharan,Bharatiya Janata Party,49155,1065,50220,35.34,Palakkad
4,Shafi Parambil,Indian National Congress,53080,999,54079,38.06,Palakkad
5,Jayaprakash. J,Samajwadi Forward Bloc,217,4,221,0.16,Palakkad
6,K. Rajesh,Akhil Bharat Hindu Mahasabha,104,1,105,0.07,Palakkad
7,V. Sachidanandan,Independent,152,7,159,0.11,Palakkad
8,Nota,None of the Above,514,14,528,0.37,Palakkad
1,Jayaprakasan K.P.,Bharatiya Janata Party,18237,228,18465,14.06,Tarur
2,K.A.Sheeba,Indian National Congress,42271,942,43213,32.9,Tarur
3,P.P.Sumod,Communist Party of India (Marxist),66560,1184,67744,51.58,Tarur
4,C.A.Ushakumari,Welfare Party Of India,956,29,985,0.75,Tarur
5,Nota,None of the Above,928,12,940,0.72,Tarur
1,K. Krishnankutty,Janata Dal (Secular),82816,1856,84672,55.38,Chittur
2,A. Chandran,Bahujan Samaj Party,907,11,918,0.6,Chittur
3,V. Natesan,Bharatiya Janata Party,14257,201,14458,9.46,Chittur
4,Adv. Sumesh Achuthan,Indian National Congress,49724,1070,50794,33.22,Chittur
5,Prameela. K,Independent,542,10,552,0.36,Chittur
6,Nsk Puram Sasikumar,Independent,226,0,226,0.15,Chittur
7,Nota,None of the Above,1273,12,1285,0.84,Chittur
1,Prakash.C,Bahujan Samaj Party,1302,48,1350,0.89,Nenmara
2,K. Babu,Communist Party of India (Marxist),77887,2258,80145,52.89,Nenmara
3,Anurag .A.N,Bharath Dharma Jana Sena,16388,278,16666,11,Nenmara
4,C.N.Vijayakrishnan,Communist Marxist Party Kerala State Committee,50491,950,51441,33.95,Nenmara
5,Babu S/O Kunchu,Independent,841,22,863,0.57,Nenmara
6,Nota,None of the Above,1049,21,1070,0.71,Nenmara
1,Chandran,Bahujan Samaj Party,688,11,699,0.52,Alathur
2,Palayam Pradeep,Indian National Congress,39762,773,40535,29.94,Alathur
3,Prasanth Sivan,Bharatiya Janata Party,18115,234,18349,13.56,Alathur
4,K.D.Prasenan,Communist Party of India (Marxist),72947,1706,74653,55.15,Alathur
5,Rajesh.M,Independent,339,8,347,0.26,Alathur
6,Nota,None of the Above,765,18,783,0.58,Alathur
1,K Radhakrishnan,Communist Party of India (Marxist),81885,1530,83415,54.41,Chelakkara
2,C C Sreekumar,Indian National Congress,43150,865,44015,28.71,Chelakkara
3,Shajumon Vattekkad,Bharatiya Janata Party,23716,329,24045,15.68,Chelakkara
4,Chandran Thiyath,SOCIAL DEMOCRATIC PARTY OF INDIA,1110,10,1120,0.73,Chelakkara
5,Nota,None of the Above,709,11,720,0.47,Chelakkara
1,Adv. K.K.Aneeshkumar,Bharatiya Janata Party,27479,354,27833,17.98,Kunnamkulam
2,K.Jayasankar,Indian National Congress,47478,1423,48901,31.58,Kunnamkulam
3,A.C.Moideen,Communist Party of India (Marxist),73979,1553,75532,48.78,Kunnamkulam
4,V.S.Aboobacker,SOCIAL DEMOCRATIC PARTY OF INDIA,1229,12,1241,0.8,Kunnamkulam
5,James Panadan,Independent,258,7,265,0.17,Kunnamkulam
6,Moideen.K.M S/O Muhammed,Independent,365,15,380,0.25,Kunnamkulam
7,A.K.Moidheenkutty,Independent,110,10,120,0.08,Kunnamkulam
8,Nota,None of the Above,554,5,559,0.36,Kunnamkulam
1,N.K.Akbar,Communist Party of India (Marxist),76052,1020,77072,52.52,Guruvayoor
2,Adv.K N A Khader,Indian Union Muslim League,57918,886,58804,40.07,Guruvayoor
3,Asharaf Vadakkoot,SOCIAL DEMOCRATIC PARTY OF INDIA,2870,19,2889,1.97,Guruvayoor
4,M.Kumar,SOCIALIST UNITY CENTRE OF INDIA (COMMUNIST),288,13,301,0.21,Guruvayoor
5,Dileep Nair,Democratic Social Justice Party,6222,72,6294,4.29,Guruvayoor
6,Antony,Independent,382,10,392,0.27,Guruvayoor
7,Nota,None of the Above,997,10,1007,0.69,Guruvayoor
1,Abhayan.N.A,Bahujan Samaj Party,449,23,472,0.28,Manalur
2,Murali,Communist Party of India (Marxist),76339,1998,78337,46.77,Manalur
3,Radhakrishnan,Bharatiya Janata Party,35951,615,36566,21.83,Manalur
4,Vijay Hari,Indian National Congress,46607,1854,48461,28.93,Manalur
5,Faisal,SOCIAL DEMOCRATIC PARTY OF INDIA,2266,28,2294,1.37,Manalur
6,M K Devarajan,Independent,648,12,660,0.39,Manalur
7,Nota,None of the Above,712,0,712,0.43,Manalur
1,Anil Akkara,Indian National Congress,64089,1769,65858,38.77,Wadakkanchery
2,T.S Ullas Babu,Bharatiya Janata Party,21408,339,21747,12.8,Wadakkanchery
3,Xavier Chittilappilly,Communist Party of India (Marxist),79216,1810,81026,47.7,Wadakkanchery
4,Haji Aboobaker Kundukadan,Independent,378,10,388,0.23,Wadakkanchery
5,Nota,None of the Above,829,13,842,0.5,Wadakkanchery
1,Adv. B Gopalakrishnan,Bharatiya Janata Party,22065,230,22295,14.28,Ollur
2,Jose Valloor,Indian National Congress,54100,1051,55151,35.31,Ollur
3,K Rajan,Communist Party of India,75357,1300,76657,49.09,Ollur
4,P K Subramanian,Bahujan Samaj Party,276,6,282,0.18,Ollur
5,K K George Kakkassery,Independent,621,7,628,0.4,Ollur
6,Benny Kodiyatil,Independent,330,1,331,0.21,Ollur
7,Nota,None of the Above,814,13,827,0.53,Ollur
1,Padmaja Venugopal,Indian National Congress,41996,1321,43317,33.52,Thrissur
2,P Balachandran,Communist Party of India,43048,1215,44263,34.25,Thrissur
3,Suresh Gopi,Bharatiya Janata Party,39616,841,40457,31.3,Thrissur
4,Thrissur Mukundan,Indian Gandhiyan Party,217,8,225,0.17,Thrissur
5,Ajith Menon Ponnemkattil,Independent,243,9,252,0.19,Thrissur
6,Nota,None of the Above,712,11,723,0.56,Thrissur
1,C C Mukundhan,Communist Party of India,71297,1633,72930,47.49,Nattika
2,Lojanan Ambatt,Bharatiya Janata Party,33190,526,33716,21.96,Nattika
3,Vimal Mallika Vijayan,Bahujan Samaj Party,357,10,367,0.24,Nattika
4,Adv. Sunil Laloor,Indian National Congress,43379,1120,44499,28.98,Nattika
5,C S Jitheshkumar,Independent,604,13,617,0.4,Nattika
6,Sivarathnan Alathi,Independent,585,10,595,0.39,Nattika
7,Nota,None of the Above,815,15,830,0.54,Nattika
1,E T Taison Master,Communist Party of India,71666,1495,73161,53.76,Kaipamangalam
2,Thankamany Tharayil,Bahujan Samaj Party,434,8,442,0.32,Kaipamangalam
3,Sobha Subin,Indian National Congress,49505,958,50463,37.08,Kaipamangalam
4,M K Aslam,Welfare Party Of India,1630,41,1671,1.23,Kaipamangalam
5,C D Sreelal,Bharath Dharma Jana Sena,8913,153,9066,6.66,Kaipamangalam
6,M K Shameer,SOCIAL DEMOCRATIC PARTY OF INDIA,808,6,814,0.6,Kaipamangalam
7,Nota,None of the Above,457,9,466,0.34,Kaipamangalam
1,Jacob Thomas,Bharatiya Janata Party,33685,644,34329,22.12,Irinjalakkuda
2,R Bindu,Communist Party of India (Marxist),60843,1650,62493,40.27,Irinjalakkuda
3,Thomas J Unniyadan,Kerala Congress,54851,1693,56544,36.44,Irinjalakkuda
4,Joshy,Independent,292,13,305,0.2,Irinjalakkuda
5,Bindu,Independent,206,14,220,0.14,Irinjalakkuda
6,Bindu,Independent,141,21,162,0.1,Irinjalakkuda
7,Vaxerin,Independent,503,33,536,0.35,Irinjalakkuda
8,Nota,None of the Above,583,7,590,0.38,Irinjalakkuda
1,A. Nagesh (Parameswaran.A),Bharatiya Janata Party,34200,693,34893,22.33,Puthukkad
2,P.C. Pushpakaran,Bahujan Samaj Party,440,15,455,0.29,Puthukkad
3,K.K. Ramachandran,Communist Party of India (Marxist),71250,2115,73365,46.94,Puthukkad
4,Sunil Anthikkad (Sunilkumar. P.V),Indian National Congress,44530,1482,46012,29.44,Puthukkad
5,Rajesh Appatt,Communist Party of India (Marxist-Leninist) Red Star,475,14,489,0.31,Puthukkad
6,Nota,None of the Above,1053,16,1069,0.68,Puthukkad
1,M S Asokan,Bahujan Samaj Party,597,20,617,0.43,Chalakkudy
2,Dennies K Antony,Kerala Congress (M),59516,1315,60831,42.49,Chalakkudy
3,Saneeshkumar Joseph,Indian National Congress,60452,1436,61888,43.23,Chalakkudy
4,Unnikrishnan K.A,Bharath Dharma Jana Sena,17014,287,17301,12.09,Chalakkudy
5,Dharmajan P K,SOCIALIST UNITY CENTRE OF INDIA (COMMUNIST),244,9,253,0.18,Chalakkudy
6,Cheriya,Independent,137,6,143,0.1,Chalakkudy
7,Joshy Vattoly,Independent,143,17,160,0.11,Chalakkudy
8,T N Rajan,Independent,692,21,713,0.5,Chalakkudy
9,Rosilin,Independent,234,14,248,0.17,Chalakkudy
10,Nota,None of the Above,983,17,1000,0.7,Chalakkudy
1,M. P. Jackson,Indian National Congress,46017,1547,47564,31.94,Kodungallur
2,Remya Mohanan,Bahujan Samaj Party,342,24,366,0.25,Kodungallur
3,Santhosh Cherakkulam,Bharatiya Janata Party,27600,604,28204,18.94,Kodungallur
4,Adv. V. R. Sunilkumar,Communist Party of India,69447,2010,71457,47.99,Kodungallur
5,O. M. Sreeja,SOCIALIST UNITY CENTRE OF INDIA (COMMUNIST),262,8,270,0.18,Kodungallur
6,Rajan Painat,Independent,162,9,171,0.11,Kodungallur
7,Nota,None of the Above,865,5,870,0.58,Kodungallur
1,Adv Eldose P Kunnapillil,Indian National Congress,52055,1429,53484,37.1,Perumbavoor
2,Babu Joseph Perumbavoor,Kerala Congress (M),49438,1147,50585,35.09,Perumbavoor
3,Adv.T P Sindhumol,Bharatiya Janata Party,14813,322,15135,10.5,Perumbavoor
4,Ajmal K Mujeeb,SOCIAL DEMOCRATIC PARTY OF INDIA,2483,11,2494,1.73,Perumbavoor
5,Arshad K M,Welfare Party Of India,1029,9,1038,0.72,Perumbavoor
6,Chithra Sukumaran,Twenty 20 Party,20153,383,20536,14.24,Perumbavoor
7,Babu Joseph Erumala,Independent,188,8,196,0.14,Perumbavoor
8,Nota,None of the Above,686,17,703,0.49,Perumbavoor
1,Adv. Jose Thettayil,Janata Dal (Secular),54620,1013,55633,40.31,Angamaly
2,Adv. K V Sabu,Bharatiya Janata Party,8547,130,8677,6.29,Angamaly
3,Stalin Nikathithara,Bahujan Samaj Party,322,4,326,0.24,Angamaly
4,Roji M John,Indian National Congress,70163,1399,71562,51.86,Angamaly
5,Jothilakshmi,SOCIALIST UNITY CENTRE OF INDIA (COMMUNIST),292,9,301,0.22,Angamaly
6,Martin Paul,Independent,621,2,623,0.45,Angamaly
7,Velayudhan,Independent,200,6,206,0.15,Angamaly
8,Nota,None of the Above,647,22,669,0.48,Angamaly
1,Anwar Sadath,Indian National Congress,72500,1203,73703,49,Aluva
2,M.N. Gopi,Bharatiya Janata Party,15660,233,15893,10.57,Aluva
3,A.G. Ajayan,SOCIALIST UNITY CENTRE OF INDIA (COMMUNIST),224,4,228,0.15,Aluva
4,Viswakala Thankappan,Marxist Communist Party of India (United),340,2,342,0.23,Aluva
5,K.M. Shefrin,Welfare Party Of India,1681,32,1713,1.14,Aluva
6,V.A Rasheed,SOCIAL DEMOCRATIC PARTY OF INDIA,2194,30,2224,1.48,Aluva
7,Ar Shelna Nishad,Independent,54042,775,54817,36.44,Aluva
8,K.V. Sarala,Independent,558,11,569,0.38,Aluva
9,Nota,None of the Above,931,8,939,0.62,Aluva
1,Adv. V. E. Abdul Gafoor,Indian Union Muslim League,60829,976,61805,39.65,Kalamassery
2,P. S. Unnikrishnan,Bahujan Samaj Party,840,17,857,0.55,Kalamassery
3,P. Rajeeve,Communist Party of India (Marxist),75757,1384,77141,49.49,Kalamassery
4,P. S. Jayaraj,Bharath Dharma Jana Sena,11021,158,11179,7.17,Kalamassery
5,V. M. Faisal,SOCIAL DEMOCRATIC PARTY OF INDIA,2372,13,2385,1.53,Kalamassery
6,Nayana Unnikrishnan,Independent,443,9,452,0.29,Kalamassery
7,P. M. K. Bava,Independent,514,12,526,0.34,Kalamassery
8,Nota,None of the Above,1483,35,1518,0.97,Kalamassery
1,M.T. Nixon,Communist Party of India,59675,1288,60963,38.44,Paravur
2,N.K.Biju,Bahujan Samaj Party,708,16,724,0.46,Paravur
3,V.D. Satheesan,Indian National Congress,80463,1801,82264,51.87,Paravur
4,A.B. Jayaprakash,Bharath Dharma Jana Sena,12818,146,12964,8.17,Paravur
5,Prasanth,Independent,276,3,279,0.18,Paravur
6,Sathyanesan Ezhikkara,Independent,283,4,287,0.18,Paravur
7,Nota,None of the Above,1093,20,1113,0.7,Paravur
1,K.N. Unnikrishnan,Communist Party of India (Marxist),52712,1146,53858,41.24,Vypen
2,Deepak Joy,Indian National Congress,44710,947,45657,34.96,Vypen
3,Adv.K.S. Shaiju,Bharatiya Janata Party,13385,155,13540,10.37,Vypen
4,Dr.Job Chakalakal,Twenty 20 Party,16540,167,16707,12.79,Vypen
5,Dr.M.K. Mukundan,Independent,304,5,309,0.24,Vypen
6,Nota,None of the Above,518,7,525,0.4,Vypen
1,Tony Chammany,Indian National Congress,39865,688,40553,31.51,Kochi
2,K.J. Maxy,Communist Party of India (Marxist),53973,659,54632,42.45,Kochi
3,C.G.Rajagopal,Bharatiya Janata Party,10800,191,10991,8.54,Kochi
4,Shiny Antony,Twenty 20 Party,19550,126,19676,15.29,Kochi
5,Nipun Cherian,Independent,2123,26,2149,1.67,Kochi
6,Rajaneesh Babu,Independent,224,4,228,0.18,Kochi
7,Nota,None of the Above,464,10,474,0.37,Kochi
1,K. Babu,Indian National Congress,65355,520,65875,42.14,Thripunithura
2,Dr. K. S. Radhakrishnan,Bharatiya Janata Party,23578,178,23756,15.2,Thripunithura
3,Adv. M. Swaraj,Communist Party of India (Marxist),64325,558,64883,41.51,Thripunithura
4,Arun Babu. P. C.,Shiv Sena,231,1,232,0.15,Thripunithura
5,C. B. Ashokan,SOCIALIST UNITY CENTRE OF INDIA (COMMUNIST),172,1,173,0.11,Thripunithura
6,K. P. Ayappen,Independent,88,0,88,0.06,Thripunithura
7,Rajesh Pairoad,Independent,200,1,201,0.13,Thripunithura
8,Nota,None of the Above,1089,10,1099,0.7,Thripunithura
1,Padmaja S. Menon,Bharatiya Janata Party,15813,230,16043,14.57,Eranakulam
2,T. J. Vinod,Indian National Congress,45066,864,45930,41.72,Eranakulam
3,Prof. Leslie Pallath,Twenty 20 Party,10550,84,10634,9.66,Eranakulam
4,K. S. Anilkumar,Independent,215,10,225,0.2,Eranakulam
5,Ashokan,Independent,173,3,176,0.16,Eranakulam
6,Shaji George Pranatha,Independent,34528,432,34960,31.75,Eranakulam
7,Shaji George Plakkil,Independent,290,15,305,0.28,Eranakulam
8,Siciliamma Teacher,Independent,70,1,71,0.06,Eranakulam
9,Sujith C. Sukumaran,Independent,1024,18,1042,0.95,Eranakulam
10,Nota,None of the Above,705,7,712,0.65,Eranakulam
1,Adv.P.T.Thomas,Indian National Congress,58707,1132,59839,43.82,Thrikkakara
2,P.M.Shibu,Bahujan Samaj Party,322,9,331,0.24,Thrikkakara
3,S Saji,Bharatiya Janata Party,15218,265,15483,11.34,Thrikkakara
4,Krishnaprasad,Democratic Social Justice Party,174,7,181,0.13,Thrikkakara
5,Dr.Terry Thomas,Twenty 20 Party,13773,124,13897,10.18,Thrikkakara
6,Jinu,Independent,143,0,143,0.1,Thrikkakara
7,Dr.J.Jacob,Independent,44894,616,45510,33.32,Thrikkakara
8,Binoj,Independent,130,4,134,0.1,Thrikkakara
9,Subin,Independent,55,4,59,0.04,Thrikkakara
10,Riyas Yusuf,Independent,294,4,298,0.22,Thrikkakara
11,Nota,None of the Above,688,7,695,0.51,Thrikkakara
1,Manikuttan.A.T,Bahujan Samaj Party,197,8,205,0.13,Kunnathunad
2,Renu Suresh,Bharatiya Janata Party,7056,162,7218,4.66,Kunnathunad
3,Adv. P.V.Sreenijin,Communist Party of India (Marxist),51180,1171,52351,33.79,Kunnathunad
4,V.P.Sajeendran,Indian National Congress,48463,1173,49636,32.04,Kunnathunad
5,Krishnan Eranhikal,SOCIAL DEMOCRATIC PARTY OF INDIA,1289,5,1294,0.84,Kunnathunad
6,Dr. Sujith.P.Surendran,Twenty 20 Party,41890,811,42701,27.56,Kunnathunad
7,Velayudhan.V.K,Independent,165,3,168,0.11,Kunnathunad
8,Sujith.K.Surendran,Independent,761,25,786,0.51,Kunnathunad
9,Nota,None of the Above,539,26,565,0.36,Kunnathunad
1,M Ashish,Bharatiya Janata Party,10782,239,11021,6.97,Piravom
2,Dr. Sindhumol Jacob,Kerala Congress (M),58041,1651,59692,37.76,Piravom
3,Anoop Jacob,Kerala Congress (Jacob),82436,2620,85056,53.8,Piravom
4,C N Mukundan,SOCIALIST UNITY CENTRE OF INDIA (COMMUNIST),440,14,454,0.29,Piravom
5,Renju P B,Independent,200,2,202,0.13,Piravom
6,Sindhumol C,Independent,551,12,563,0.36,Piravom
7,Nota,None of the Above,1085,24,1109,0.7,Piravom
1,Eldho Abraham,Communist Party of India,56949,1315,58264,40.36,Muvattupuzha
2,Jiji Joseph,Bharatiya Janata Party,7335,192,7527,5.21,Muvattupuzha
3,Dr. Mathew Kuzhalnadan,Indian National Congress,62417,2008,64425,44.63,Muvattupuzha
4,C. K. Thampi,SOCIALIST UNITY CENTRE OF INDIA (COMMUNIST),170,6,176,0.12,Muvattupuzha
5,Adv. C.N. Prakash,Twenty 20 Party,13308,227,13535,9.38,Muvattupuzha
6,Nota,None of the Above,421,6,427,0.3,Muvattupuzha
1,Antony John,Communist Party of India (Marxist),62425,1809,64234,46.99,Kothamangalam
2,Dr. Joe Joseph,Twenty 20 Party,7795,183,7978,5.84,Kothamangalam
3,T.M. Moosa,SOCIAL DEMOCRATIC PARTY OF INDIA,1273,13,1286,0.94,Kothamangalam
4,Shibu Thekkumpuram,Kerala Congress,55868,1761,57629,42.16,Kothamangalam
5,Shine K Krishnan,Bharath Dharma Jana Sena,4532,106,4638,3.39,Kothamangalam
6,Anto Johny,Independent,121,15,136,0.1,Kothamangalam
7,Shibu,Independent,101,5,106,0.08,Kothamangalam
8,Shibu Thekkan,Independent,261,15,276,0.2,Kothamangalam
9,Nota,None of the Above,372,42,414,0.3,Kothamangalam
1,D. Kumar,Indian National Congress,50421,780,51201,44.22,Devikulam
2,Adv. A. Raja,Communist Party of India (Marxist),58183,866,59049,51,Devikulam
3,Ganesan. S,Independent,4675,42,4717,4.07,Devikulam
4,Nota,None of the Above,804,3,807,0.7,Devikulam
1,Adv. E.M. Augusthy,Indian National Congress,38207,869,39076,31.21,Udumbanchola
2,A C Biju,Bahujan Samaj Party,858,9,867,0.69,Udumbanchola
3,M. M. Mani,Communist Party of India (Marxist),75938,1443,77381,61.8,Udumbanchola
4,Santhosh Madhavan,Bharath Dharma Jana Sena,7121,87,7208,5.76,Udumbanchola
5,Nota,None of the Above,679,8,687,0.55,Udumbanchola
1,Prof. K I Antony,Kerala Congress (M),45762,1474,47236,34.03,Thodupuzha
2,Leethesh P T,Bahujan Samaj Party,928,6,934,0.67,Thodupuzha
3,Shyamraj P,Bharatiya Janata Party,20758,505,21263,15.32,Thodupuzha
4,P J Joseph,Kerala Congress,64895,2600,67495,48.63,Thodupuzha
5,T R Sreedharan,SOCIALIST UNITY CENTRE OF INDIA (COMMUNIST),263,10,273,0.2,Thodupuzha
6,M T Thomas,Independent,556,6,562,0.4,Thodupuzha
7,Parthasaradhi K,Independent,365,5,370,0.27,Thodupuzha
8,Nota,None of the Above,640,34,674,0.49,Thodupuzha
1,Babu Varghese Vattoli,Bahujan Samaj Party,1096,10,1106,0.84,Idukki
2,Roshy Augustine,Kerala Congress (M),61033,1335,62368,47.48,Idukki
3,Adv. K Francis George,Kerala Congress,55439,1356,56795,43.24,Idukki
4,Adv. Sangeetha Viswanathan,Bharath Dharma Jana Sena,9148,138,9286,7.07,Idukki
5,Bijeesh Thomas,Independent,604,6,610,0.46,Idukki
6,Vincent Jacob,Independent,336,4,340,0.26,Idukki
7,Sajeev,Independent,164,5,169,0.13,Idukki
8,Nota,None of the Above,661,16,677,0.52,Idukki
1,Biju Mattappally,Bahujan Samaj Party,812,6,818,0.64,Peerumade
2,Vazhoor Soman,Communist Party of India,59518,623,60141,47.25,Peerumade
3,Sreenagari Rajan,Bharatiya Janata Party,7085,41,7126,5.6,Peerumade
4,Adv.Syriac Thomas,Indian National Congress,57601,705,58306,45.81,Peerumade
5,P.K Gopalakrishnan,Independent,249,2,251,0.2,Peerumade
6,Soman,Independent,247,1,248,0.19,Peerumade
7,Nota,None of the Above,400,1,401,0.32,Peerumade
1,Joy Thomas Vazhamattom,Bahujan Samaj Party,355,13,368,0.27,Pala
2,Jose K. Mani,Kerala Congress (M),52697,1729,54426,39.32,Pala
3,Prameeladevi .J,Bharatiya Janata Party,10533,336,10869,7.85,Pala
4,Albin Mathew,Independent,118,3,121,0.09,Pala
5,C. V. John,Independent,243,6,249,0.18,Pala
6,Thomas J. Nidiry,Independent,158,2,160,0.12,Pala
7,Mani C Kappen,Independent,67638,2166,69804,50.43,Pala
8,Mani C. Kuriakose,Independent,1065,33,1098,0.79,Pala
9,Sreejith V S,Independent,191,4,195,0.14,Pala
10,Santhosh Pulickal,Independent,439,5,444,0.32,Pala
11,Sunil Alancheril,Independent,88,5,93,0.07,Pala
12,Nota,None of the Above,597,7,604,0.44,Pala
1,Adv. Anju Mathew,Bahujan Samaj Party,1188,19,1207,0.92,Kaduthuruthy
2,Ligin Lal,Bharatiya Janata Party,11419,251,11670,8.88,Kaduthuruthy
3,Stephen George,Kerala Congress (M),53819,1591,55410,42.17,Kaduthuruthy
4,Adv. Jaimon Thankachan,Samajwadi Jan Parishad,287,15,302,0.23,Kaduthuruthy
5,Adv. Mons Joseph,Kerala Congress,57856,1810,59666,45.4,Kaduthuruthy
6,Vinod K Jose,Independent,2386,39,2425,1.85,Kaduthuruthy
7,Nota,None of the Above,727,4,731,0.56,Kaduthuruthy
1,Akhiljith Kallara,Bahujan Samaj Party,704,22,726,0.57,Vaikom
2,C.K Asha,Communist Party of India,69483,1905,71388,55.96,Vaikom
3,Dr.P.R Sona,Indian National Congress,41108,1158,42266,33.13,Vaikom
4,Ajitha Sabu,Bharath Dharma Jana Sena,11708,245,11953,9.37,Vaikom
5,Bindu,Bahujan Dravida Party,251,7,258,0.2,Vaikom
6,T.K Sabu,SOCIALIST UNITY CENTRE OF INDIA (COMMUNIST),140,12,152,0.12,Vaikom
7,Kuttan Kattachira,Independent,150,13,163,0.13,Vaikom
8,Nota,None of the Above,657,13,670,0.53,Vaikom
1,Jijith K Joy,Bahujan Samaj Party,1135,30,1165,0.92,Ettumanoor
2,V N Vasavan,Communist Party of India (Marxist),56632,1657,58289,46.2,Ettumanoor
3,T N Harikumar,Bharatiya Janata Party,13401,345,13746,10.9,Ettumanoor
4,A G Ajayakumar,SOCIALIST UNITY CENTRE OF INDIA (COMMUNIST),244,3,247,0.2,Ettumanoor
5,Adv. Prince Lukose,Kerala Congress,42598,1388,43986,34.86,Ettumanoor
6,Charley Thomas Panikkaridam,Independent,305,25,330,0.26,Ettumanoor
7,Lathika Subhash,Independent,7410,214,7624,6.04,Ettumanoor
8,Nota,None of the Above,768,12,780,0.62,Ettumanoor
1,Adv.K.Anilkumar,Communist Party of India (Marxist),45974,684,46658,38.33,Kottayam
2,Thiruvanchoor Radhakrishnan,Indian National Congress,64309,1092,65401,53.72,Kottayam
3,Minerva Mohan,Bharatiya Janata Party,8501,110,8611,7.07,Kottayam
4,Sreekumar Chakkala,Bahujan Samaj Party,372,2,374,0.31,Kottayam
5,Arun Mangattu,Akhil Bharat Hindu Mahasabha,75,2,77,0.06,Kottayam
6,M.K.Shahazad,SOCIALIST UNITY CENTRE OF INDIA (COMMUNIST),138,6,144,0.12,Kottayam
7,Nota,None of the Above,468,5,473,0.39,Kottayam
1,Abhilash P P,Bahujan Samaj Party,751,12,763,0.58,Puthuppally
2,Oommen Chandy,Indian National Congress,61606,1766,63372,48.08,Puthuppally
3,Jaick C Thomas,Communist Party of India (Marxist),53379,949,54328,41.22,Puthuppally
4,N Hari,Bharatiya Janata Party,11495,199,11694,8.87,Puthuppally
5,M V Cherian,SOCIALIST UNITY CENTRE OF INDIA (COMMUNIST),141,5,146,0.11,Puthuppally
6,George Joseph Vathappally,Independent,988,9,997,0.76,Puthuppally
7,Nota,None of the Above,483,14,497,0.38,Puthuppally
1,Amruth Dev T,Bahujan Samaj Party,1048,31,1079,0.87,Changanassery
2,Adv. Job Maichil,Kerala Congress (M),54244,1181,55425,44.85,Changanassery
3,Adv G Raman Nair,Bharatiya Janata Party,14106,385,14491,11.73,Changanassery
4,M. K. Nizamuddin,SOCIAL DEMOCRATIC PARTY OF INDIA,1065,10,1075,0.87,Changanassery
5,Rejitha Jayaram,SOCIALIST UNITY CENTRE OF INDIA (COMMUNIST),323,5,328,0.27,Changanassery
6,V. J. Laly,Kerala Congress,47997,1369,49366,39.94,Changanassery
7,Joemon Joseph Srampickal,Independent,138,19,157,0.13,Changanassery
8,Tijo Karikkandam,Independent,1077,17,1094,0.89,Changanassery
9,Babychen Mukkadan,Independent,134,2,136,0.11,Changanassery
10,Nota,None of the Above,430,4,434,0.35,Changanassery
1,Alphons Kannanthanam,Bharatiya Janata Party,28568,589,29157,21.17,Kanjirappally
2,Ashik M M,Bahujan Samaj Party,720,7,727,0.53,Kanjirappally
3,Dr.N.Jayaraj,Kerala Congress (M),59151,1148,60299,43.79,Kanjirappally
4,Joseph Vazhackan,Indian National Congress,45296,1300,46596,33.84,Kanjirappally
5,Mayamol K P,SOCIALIST UNITY CENTRE OF INDIA (COMMUNIST),292,8,300,0.22,Kanjirappally
6,Nota,None of the Above,622,2,624,0.45,Kanjirappally
1,Ancy George,Bahujan Samaj Party,590,6,596,0.43,Poonjar
2,Adv. Tomy Kallany,Indian National Congress,33694,939,34633,24.76,Poonjar
3,Adv. Sebastian Kulathunkal,Kerala Congress (M),57630,1038,58668,41.94,Poonjar
4,Abdu Samad,Kerala Janatha Party,253,6,259,0.19,Poonjar
5,P.C.George Plathottam,"Kerala Janapaksham (Secular),",41049,802,41851,29.92,Poonjar
6,M. P. Sen,Bharath Dharma Jana Sena,2928,37,2965,2.12,Poonjar
7,Albin Mathew,Independent,201,4,205,0.15,Poonjar
8,M. V. George,Independent,264,14,278,0.2,Poonjar
9,Tomy Chemarapallil,Independent,91,3,94,0.07,Poonjar
10,Nota,None of the Above,332,13,345,0.25,Poonjar
1,Daleema,Communist Party of India (Marxist),73865,1752,75617,45.97,Aroor
2,Rugma Pradeep,Bahujan Samaj Party,665,17,682,0.41,Aroor
3,Adv. Shanimol Osman,Indian National Congress,67023,1581,68604,41.71,Aroor
4,Aniyappan,Bharath Dharma Jana Sena,17233,246,17479,10.63,Aroor
5,Ambika K N (Priyanka Anup),Democratic Social Justice Party,466,9,475,0.29,Aroor
6,K Prathapan,SOCIALIST UNITY CENTRE OF INDIA (COMMUNIST),358,16,374,0.23,Aroor
7,Pramod Perumpuzha,Anna Democratic Human Rights Movement Party of India,161,0,161,0.1,Aroor
8,Vayalar Rajeevan,Bahujan Dravida Party,159,5,164,0.1,Aroor
9,Chandran,Independent,88,1,89,0.05,Aroor
10,Nota,None of the Above,833,13,846,0.51,Aroor
1,Vayalar Jayakumar,Bahujan Samaj Party,594,19,613,0.34,Cherthala
2,P Prasad,Communist Party of India,80876,2826,83702,47,Cherthala
3,Adv.S Sarath,Indian National Congress,74886,2668,77554,43.55,Cherthala
4,Adv.P S Jyothis,Bharath Dharma Jana Sena,14254,308,14562,8.18,Cherthala
5,Karthikeyan,Independent,192,1,193,0.11,Cherthala
6,Sarath S Kannattuveli,Independent,487,14,501,0.28,Cherthala
7,Shajahan V A,Independent,178,23,201,0.11,Cherthala
8,Adv.Sonnymon K Mathew,Independent,164,5,169,0.09,Cherthala
9,Nota,None of the Above,583,19,602,0.34,Cherthala
1,P.P Chitharanjan,Communist Party of India (Marxist),71262,2150,73412,46.33,Alappuzha
2,Dr.K.S Manoj,Indian National Congress,60095,1673,61768,38.98,Alappuzha
3,Sandeep Vachaspati,Bharatiya Janata Party,21204,446,21650,13.66,Alappuzha
4,Subeendran K.C,Bahujan Samaj Party,204,3,207,0.13,Alappuzha
5,K.A Vinod,SOCIALIST UNITY CENTRE OF INDIA (COMMUNIST),202,3,205,0.13,Alappuzha
6,Shylendran,Bahujan Dravida Party,114,1,115,0.07,Alappuzha
7,Nota,None of the Above,1068,21,1089,0.69,Alappuzha
1,Anoop Antony,Bharatiya Janata Party,21974,415,22389,16.34,Ambalapuzha
2,Adv.M.Liju,Indian National Congress,48841,1399,50240,36.67,Ambalapuzha
3,H.Salam,Communist Party of India (Marxist),59602,1763,61365,44.79,Ambalapuzha
4,M.M.Thahir,SOCIAL DEMOCRATIC PARTY OF INDIA,1672,18,1690,1.23,Ambalapuzha
5,Subaida,SOCIALIST UNITY CENTRE OF INDIA (COMMUNIST),218,3,221,0.16,Ambalapuzha
6,Subhadramma Thottappally,Welfare Party Of India,513,12,525,0.38,Ambalapuzha
7,Nota,None of the Above,562,29,591,0.43,Ambalapuzha
1,Thomas K Thomas,Nationalist Congress Party,55532,1847,57379,45.67,Kuttanad
2,Adv. Jacob Abraham,Kerala Congress,49876,1987,51863,41.28,Kuttanad
3,Thampi Mettuthara,Bharath Dharma Jana Sena,14551,395,14946,11.9,Kuttanad
4,Biju Xavier,SOCIALIST UNITY CENTRE OF INDIA (COMMUNIST),369,23,392,0.31,Kuttanad
5,Dr. Vinu,Democratic Social Justice Party,514,19,533,0.42,Kuttanad
6,Nota,None of the Above,513,10,523,0.42,Kuttanad
1,Ramesh Chennithala,Indian National Congress,70056,2712,72768,48.31,Haripad
2,Adv. R. Sajilal,Communist Party of India,57251,1851,59102,39.24,Haripad
3,K. Soman,Bharatiya Janata Party,17441,449,17890,11.88,Haripad
4,Madhu. T,SOCIALIST UNITY CENTRE OF INDIA (COMMUNIST),194,10,204,0.14,Haripad
5,Adv. Niyaz Bharati,Independent,118,5,123,0.08,Haripad
6,Nota,None of the Above,525,11,536,0.36,Haripad
1,Aritha Babu,Indian National Congress,69044,2006,71050,44.06,Kayamkulam
2,Adv. U. Prathibha,Communist Party of India (Marxist),75173,2175,77348,47.97,Kayamkulam
3,Pradeeplal,Bharath Dharma Jana Sena,11087,326,11413,7.08,Kayamkulam
4,Myna Gopinath,SOCIALIST UNITY CENTRE OF INDIA (COMMUNIST),145,5,150,0.09,Kayamkulam
5,Geevarghese Samuel,Independent,201,4,205,0.13,Kayamkulam
6,Maniyappan Achari,Independent,354,13,367,0.23,Kayamkulam
7,Rajeev R,Independent,216,15,231,0.14,Kayamkulam
8,Sathyanarayanan S,Independent,67,6,73,0.05,Kayamkulam
9,Nota,None of the Above,414,6,420,0.26,Kayamkulam
1,M S Arun Kumar,Communist Party of India (Marxist),69623,2120,71743,47.61,Mavelikara
2,K K Shaju,Indian National Congress,45246,1780,47026,31.21,Mavelikara
3,K Sanju,Bharatiya Janata Party,30215,740,30955,20.54,Mavelikara
4,K Sasikumar,SOCIALIST UNITY CENTRE OF INDIA (COMMUNIST),147,4,151,0.1,Mavelikara
5,Suresh Nooranad,Ambedkarite Party of India,158,7,165,0.11,Mavelikara
6,B Subhash,Independent,128,3,131,0.09,Mavelikara
7,Nota,None of the Above,513,6,519,0.34,Mavelikara
1,M. V. Gopakumar,Bharatiya Janata Party,33789,831,34620,23.52,Chengannur
2,M. Murali,Indian National Congress,38099,1310,39409,26.78,Chengannur
3,Shaji T. George,Bahujan Samaj Party,523,11,534,0.36,Chengannur
4,Saji Cherian,Communist Party of India (Marxist),69501,2001,71502,48.58,Chengannur
5,T. K. Gopinathan,SOCIALIST UNITY CENTRE OF INDIA (COMMUNIST),308,8,316,0.21,Chengannur
6,Melvin. K. Mathew,Democratic Social Justice Party,190,8,198,0.13,Chengannur
7,Poulose,Independent,99,2,101,0.07,Chengannur
8,Nota,None of the Above,449,42,491,0.33,Chengannur
1,Ashokan Kulanada,Bharatiya Janata Party,21954,720,22674,16.25,Thiruvalla
2,Adv. Mathew T Thomas,Janata Dal (Secular),60036,2142,62178,44.56,Thiruvalla
3,Rajendradas,Bahujan Samaj Party,1049,25,1074,0.77,Thiruvalla
4,Kunju Koshy Paul,Kerala Congress,48665,2092,50757,36.37,Thiruvalla
5,Vinod Kumar,Democratic Social Justice Party,377,3,380,0.27,Thiruvalla
6,Adv. Thomas Mathew (Roy),Independent,1423,38,1461,1.05,Thiruvalla
7,K .P Yesudas,Independent,180,16,196,0.14,Thiruvalla
8,Surendran Kottoorathil,Independent,212,4,216,0.15,Thiruvalla
9,Nota,None of the Above,570,38,608,0.44,Thiruvalla
1,Adv. Anumol N.,Bahujan Samaj Party,1132,27,1159,0.91,Ranni
2,Adv. Pramod Narayan,Kerala Congress (M),51111,1558,52669,41.22,Ranni
3,Rinku Cherian,Indian National Congress,49398,1986,51384,40.21,Ranni
4,Asharaf Pezhumkattil,SOCIAL DEMOCRATIC PARTY OF INDIA,875,11,886,0.69,Ranni
5,Jomon Kochethu,Rashtriya Janata Dal,336,3,339,0.27,Ranni
6,K. Padmakumar,Bharath Dharma Jana Sena,19043,544,19587,15.33,Ranni
7,Aji B. Ranni,Independent,269,13,282,0.22,Ranni
8,Benny Puthenparampil (Thomas Mathew),Independent,818,24,842,0.66,Ranni
9,Adv. Manju K. Nair (Kottarathil),Independent,194,4,198,0.15,Ranni
10,Nota,None of the Above,422,9,431,0.34,Ranni
1,Biju Mathew,Bharatiya Janata Party,28226,873,29099,17.98,Aranmula
2,Veena George,Communist Party of India (Marxist),72192,2758,74950,46.3,Aranmula
3,Adv. K. Sivadasan Nair,Indian National Congress,53142,2805,55947,34.56,Aranmula
4,Omalloor Ramachandran,Ambedkarite Party of India,229,7,236,0.15,Aranmula
5,Santhi Omalloor,Anna Democratic Human Rights Movement Party of India,130,3,133,0.08,Aranmula
6,Arjunan C. K,Independent,65,2,67,0.04,Aranmula
7,Prasanth Aranmula,Independent,129,14,143,0.09,Aranmula
8,Sivadasan Nair S/O Raghavan Nair,Independent,607,22,629,0.39,Aranmula
9,G. Sugathan,Independent,86,1,87,0.05,Aranmula
10,Nota,None of the Above,564,11,575,0.36,Aranmula
1,Adv. K.U Jenish Kumar,Communist Party of India (Marxist),60166,2152,62318,41.62,Konni
2,K. Surendran,Bharatiya Janata Party,31994,817,32811,21.91,Konni
3,Robin Peter,Indian National Congress,51859,1951,53810,35.94,Konni
4,Raghu P,Anna Democratic Human Rights Movement Party of India,212,2,214,0.14,Konni
5,Suku Balan,Ambedkarite Party of India,120,2,122,0.08,Konni
6,Manoharan,Independent,72,3,75,0.05,Konni
7,Nota,None of the Above,370,2,372,0.25,Konni
1,M. G. Kannan,Indian National Congress,61488,2162,63650,40.96,Adoor
2,Chittayam Gopakumar,Communist Party of India,63958,2611,66569,42.83,Adoor
3,Adv. Pandalam Prathapan,Bharatiya Janata Party,23299,681,23980,15.43,Adoor
4,Vipin Kanikonathu,Bahujan Samaj Party,177,1,178,0.11,Adoor
5,Rajankulakkada,Anna Democratic Human Rights Movement Party of India,88,7,95,0.06,Adoor
6,Saranyaraj,SOCIALIST UNITY CENTRE OF INDIA (COMMUNIST),121,6,127,0.08,Adoor
7,R. Kannan S/O Rajan,Independent,210,8,218,0.14,Adoor
8,Nota,None of the Above,580,14,594,0.38,Adoor
1,Bitty Sudheer,Bharatiya Janata Party,11847,297,12144,7.01,Karunagappally
2,C. R Mahesh,Indian National Congress,91849,2376,94225,54.38,Karunagappally
3,R. Ramachandran,Communist Party of India,62810,2207,65017,37.52,Karunagappally
4,Bhargavan S,SOCIALIST UNITY CENTRE OF INDIA (COMMUNIST),275,8,283,0.16,Karunagappally
5,Madhu,Anna Democratic Human Rights Movement Party of India,126,2,128,0.07,Karunagappally
6,Adv. Sumayya Najeeb,SOCIAL DEMOCRATIC PARTY OF INDIA,1030,7,1037,0.6,Karunagappally
7,Nota,None of the Above,439,11,450,0.26,Karunagappally
1,Vivek Gopan,Bharatiya Janata Party,13943,268,14211,9.95,Chavara
2,Shibu Baby John,Revolutionary Socialist Party,60103,2083,62186,43.52,Chavara
3,Johnson Kandachira,Independent,1209,14,1223,0.86,Chavara
4,Viji Ratheesh,Independent,369,7,376,0.26,Chavara
5,Dr.Sujith Vijayanpillai,Independent,61220,2062,63282,44.29,Chavara
6,Sujithmon,Independent,895,6,901,0.63,Chavara
7,Nota,None of the Above,679,22,701,0.49,Chavara
1,R.S. Anju,Bahujan Samaj Party,920,26,946,0.59,Kunnathur
2,Ullas Kovoor,Revolutionary Socialist Party,64326,2320,66646,41.4,Kunnathur
3,Rajiprasad,Bharatiya Janata Party,21121,639,21760,13.52,Kunnathur
4,R. Sukumaran,Anna Democratic Human Rights Movement Party of India,319,7,326,0.2,Kunnathur
5,Arunkumar S Uliyacovil,Independent,310,15,325,0.2,Kunnathur
6,Kovoor Kunjumon,Independent,66807,2629,69436,43.13,Kunnathur
7,Manthara Velayudhan,Independent,612,11,623,0.39,Kunnathur
8,Nota,None of the Above,884,38,922,0.57,Kunnathur
1,K N Balagopal,Communist Party of India (Marxist),66612,2158,68770,45.98,Kottarakkara
2,R Resmi,Indian National Congress,56127,1829,57956,38.75,Kottarakkara
3,Adv. Vayakkal Soman,Bharatiya Janata Party,20710,513,21223,14.19,Kottarakkara
4,Usha Kottarakkara,Anna Democratic Human Rights Movement Party of India,453,7,460,0.31,Kottarakkara
5,E. Kunjumon,SOCIALIST UNITY CENTRE OF INDIA (COMMUNIST),83,4,87,0.06,Kottarakkara
6,Jaineendran T,Shiv Sena,57,0,57,0.04,Kottarakkara
7,V Venugopal,Democratic Social Justice Party,86,10,96,0.06,Kottarakkara
8,Eyyamkodu Manikuttan,Independent,81,9,90,0.06,Kottarakkara
9,Mathews K Lukose,Independent,133,3,136,0.09,Kottarakkara
10,Lal Viswan,Independent,103,0,103,0.07,Kottarakkara
11,Nota,None of the Above,568,6,574,0.38,Kottarakkara
1,V.S. Jithin Dev,Bharatiya Janata Party,12096,302,12398,9.05,Pathanapuram
2,Jyothikumar Chamakkala,Indian National Congress,51350,1590,52940,38.63,Pathanapuram
3,P. Krishnammal,Marxist Communist Party of India (United),2062,29,2091,1.53,Pathanapuram
4,K.B. Ganesh Kumar,Kerala Congress (B),65304,1972,67276,49.09,Pathanapuram
5,Adv. Faizy. M. Pasha,SOCIAL DEMOCRATIC PARTY OF INDIA,1179,13,1192,0.87,Pathanapuram
6,Baiju Pathanapuram,Anna Democratic Human Rights Movement Party of India,395,16,411,0.3,Pathanapuram
7,Aji Kadassery,Independent,247,7,254,0.19,Pathanapuram
8,Nota,None of the Above,442,32,474,0.35,Pathanapuram
1,Abdurahiman Randathani,Indian Union Muslim League,42448,923,43371,29.66,Punalur
2,Ayoor Murali,Bharatiya Janata Party,19692,377,20069,13.72,Punalur
3,P S Supal,Communist Party of India,78323,2105,80428,54.99,Punalur
4,Prakash Anchal,Anna Democratic Human Rights Movement Party of India,397,10,407,0.28,Punalur
5,K Mahesh,SOCIALIST UNITY CENTRE OF INDIA (COMMUNIST),390,17,407,0.28,Punalur
6,Thenmala Nagarajan,Independent,254,10,264,0.18,Punalur
7,Shibu M Skaria,Independent,594,23,617,0.42,Punalur
8,Nota,None of the Above,672,16,688,0.47,Punalur
1,J.Chinchurani,Communist Party of India,64754,2498,67252,45.69,Chadayamangalam
2,M.M.Naseer,Indian National Congress,51745,1829,53574,36.4,Chadayamangalam
3,Lalu,Bahujan Samaj Party,400,6,406,0.28,Chadayamangalam
4,Vishnu Pattathanam,Bharatiya Janata Party,21747,491,22238,15.11,Chadayamangalam
5,Archana Prajith,Welfare Party Of India,590,15,605,0.41,Chadayamangalam
6,Ratheesh Kadakkal,Anna Democratic Human Rights Movement Party of India,268,12,280,0.19,Chadayamangalam
7,Sharafath Mallam,SOCIAL DEMOCRATIC PARTY OF INDIA,1853,26,1879,1.28,Chadayamangalam
8,Shibu.K.Chadayamangalam,Independent,257,1,258,0.18,Chadayamangalam
9,Nota,None of the Above,671,14,685,0.47,Chadayamangalam
1,J.Mercykutty Amma,Communist Party of India (Marxist),69906,1976,71882,45.96,Kundara
2,P.C.Vishnunadh,Indian National Congress,74664,1741,76405,48.85,Kundara
3,R.Rahul,SOCIALIST UNITY CENTRE OF INDIA (COMMUNIST),444,13,457,0.29,Kundara
4,Vanaja Vidyadharan,Bharath Dharma Jana Sena,5983,117,6100,3.9,Kundara
5,Vinod Bahuleyan,Rashtriya Janata Dal,169,3,172,0.11,Kundara
6,Shiju M Varghese,Democratic Social Justice Party,181,5,186,0.12,Kundara
7,Sibu Karamcodu,Anna Democratic Human Rights Movement Party of India,227,2,229,0.15,Kundara
8,Santhosh Adooran,Independent,252,8,260,0.17,Kundara
9,Nota,None of the Above,692,18,710,0.45,Kundara
1,Adv. Bindhu Krishna,Indian National Congress,55035,1417,56452,43.27,Kollam
2,M Mukesh,Communist Party of India (Marxist),56898,1626,58524,44.86,Kollam
3,Remanan,Bahujan Samaj Party,282,8,290,0.22,Kollam
4,Sunil M,Bharatiya Janata Party,14029,223,14252,10.93,Kollam
5,Baby S,Anna Democratic Human Rights Movement Party of India,178,5,183,0.14,Kollam
6,Nota,None of the Above,733,17,750,0.57,Kollam
1,M. Noushad,Communist Party of India (Marxist),69793,1780,71573,56.25,Eravipuram
2,Babudivakaran,Revolutionary Socialist Party,42452,1000,43452,34.15,Eravipuram
3,Mohanan Mayyanad,Bahujan Samaj Party,535,8,543,0.43,Eravipuram
4,M. Unnikrishnan,Anna Democratic Human Rights Movement Party of India,424,6,430,0.34,Eravipuram
5,Renjith Ravindran,Bharath Dharma Jana Sena,8353,115,8468,6.66,Eravipuram
6,S. Sudhilal,SOCIALIST UNITY CENTRE OF INDIA (COMMUNIST),205,8,213,0.17,Eravipuram
7,Ayathil Riyas,SOCIAL DEMOCRATIC PARTY OF INDIA,1441,3,1444,1.13,Eravipuram
8,N. Shihabudeen,Independent,183,4,187,0.15,Eravipuram
9,Nota,None of the Above,914,17,931,0.73,Eravipuram
1,B. B. Gopakumar,Bharatiya Janata Party,41305,785,42090,30.61,Chathannur
2,G.S. Jayalal,Communist Party of India,57529,1767,59296,43.12,Chathannur
3,N. Peethambarakurup,Indian National Congress,33206,1074,34280,24.93,Chathannur
4,Sunu Bhaskaran,Bahujan Samaj Party,359,5,364,0.26,Chathannur
5,Shanmughan Paravur,Anna Democratic Human Rights Movement Party of India,518,6,524,0.38,Chathannur
6,Varinjam Rajeev,Independent,122,13,135,0.1,Chathannur
7,Sethu,Independent,168,4,172,0.13,Chathannur
8,Nota,None of the Above,616,26,642,0.47,Chathannur
1,Anu M.C,Bahujan Samaj Party,1920,28,1948,1.44,Varkala
2,Adv. V Joy,Communist Party of India (Marxist),66874,1942,68816,50.89,Varkala
3,Adv. Brm Shafeer,Indian National Congress,49849,1146,50995,37.71,Varkala
4,Aji S,Bharath Dharma Jana Sena,10957,257,11214,8.29,Varkala
5,Anilkumar P,Democratic Human Rights Movement Party,455,5,460,0.34,Varkala
6,Prince,Independent,615,43,658,0.49,Varkala
7,Shefeer,Independent,313,10,323,0.24,Varkala
8,Nota,None of the Above,801,14,815,0.6,Varkala
1,O S Ambika,Communist Party of India (Marxist),67003,2895,69898,47.35,Attingal
2,Vipinlal Vidhyadharan,Bahujan Samaj Party,894,33,927,0.63,Attingal
3,Adv. A Sreedharan,Revolutionary Socialist Party,35672,1266,36938,25.02,Attingal
4,Adv. P Sudheer,Bharatiya Janata Party,37455,807,38262,25.92,Attingal
5,Asha Prakash,Anna Democratic Human Rights Movement Party of India,332,7,339,0.23,Attingal
6,Ambili,Independent,178,13,191,0.13,Attingal
7,Nota,None of the Above,1032,39,1071,0.73,Attingal
1,Anil Mangalapuram,Bahujan Samaj Party,1077,20,1097,0.76,Chirayinkeezhu
2,B. S. Anoop,Indian National Congress,47402,1215,48617,33.51,Chirayinkeezhu
3,Ashanath G. S,Bharatiya Janata Party,30369,617,30986,21.36,Chirayinkeezhu
4,V. Sasi,Communist Party of India,60701,1933,62634,43.17,Chirayinkeezhu
5,Advocate G. Anil Kumar,Welfare Party Of India,605,11,616,0.42,Chirayinkeezhu
6,Anoop Gangan,Independent,369,3,372,0.26,Chirayinkeezhu
7,Nota,None of the Above,750,8,758,0.52,Chirayinkeezhu
1,Adv. G. R. Anil,Communist Party of India,70245,2497,72742,47.54,Nedumangad
2,Adv. J. R. Padmakumar,Bharatiya Janata Party,26242,619,26861,17.56,Nedumangad
3,P. S. Prasanth,Indian National Congress,47877,1556,49433,32.31,Nedumangad
4,Bipin Pallipuram,Bahujan Samaj Party,553,10,563,0.37,Nedumangad
5,Irshad Kanyakulangara,SOCIAL DEMOCRATIC PARTY OF INDIA,1867,17,1884,1.23,Nedumangad
6,Ebinu. S,Independent,132,14,146,0.1,Nedumangad
7,Thathankodu Kannan,Independent,165,5,170,0.11,Nedumangad
8,Prasanth. C S/O Chandran. K,Independent,145,15,160,0.1,Nedumangad
9,Hari Vellanadu,Independent,126,0,126,0.08,Nedumangad
10,Nota,None of the Above,903,14,917,0.6,Nedumangad
1,Anad Jayan,Indian National Congress,61071,1824,62895,42.92,Vamanapuram
2,Adv. D. K. Murali,Communist Party of India (Marxist),70468,2669,73137,49.91,Vamanapuram
3,Santhosh T.,Bahujan Samaj Party,542,10,552,0.38,Vamanapuram
4,Ajmal Ismail,SOCIAL DEMOCRATIC PARTY OF INDIA,2314,11,2325,1.59,Vamanapuram
5,Ashokan T. Vamanapuram,Ambedkarite Party of India,294,7,301,0.21,Vamanapuram
6,Thazhava Sahadevan,Bharath Dharma Jana Sena,5511,92,5603,3.82,Vamanapuram
7,Attukal Aji,Independent,397,23,420,0.29,Vamanapuram
8,Navas C. M.,Independent,101,33,134,0.09,Vamanapuram
9,Bharathanoor Maniraj,Independent,129,3,132,0.09,Vamanapuram
10,R. Murali,Independent,293,17,310,0.21,Vamanapuram
11,Nota,None of the Above,695,21,716,0.49,Vamanapuram
1,Kadakampally Surendran,Communist Party of India (Marxist),62176,1514,63690,46.04,Kazhakkoottam
2,Kochumani,Bahujan Samaj Party,370,7,377,0.27,Kazhakkoottam
3,Dr. S. S. Lal,Indian National Congress,32198,797,32995,23.85,Kazhakkoottam
4,Sobha Surendran,Bharatiya Janata Party,39504,689,40193,29.06,Kazhakkoottam
5,Lalumon,Independent,111,1,112,0.08,Kazhakkoottam
6,V. Sasikumaran Nair,Independent,123,6,129,0.09,Kazhakkoottam
7,Syamlal,Independent,85,0,85,0.06,Kazhakkoottam
8,Adv. Sen A. G.,Independent,71,5,76,0.05,Kazhakkoottam
9,Nota,None of the Above,655,13,668,0.48,Kazhakkoottam
1,Adv.V.K.Prasanth,Communist Party of India (Marxist),59193,1918,61111,44.4,Vattiyoorkavu
2,N.Murali,Bahujan Samaj Party,413,6,419,0.3,Vattiyoorkavu
3,Adv.V.V.Rajesh,Bharatiya Janata Party,38558,1038,39596,28.77,Vattiyoorkavu
4,Adv.Veena.S.Nair,Indian National Congress,34292,1163,35455,25.76,Vattiyoorkavu
5,A.Shyju,SOCIALIST UNITY CENTRE OF INDIA (COMMUNIST),200,1,201,0.15,Vattiyoorkavu
6,Nota,None of the Above,844,10,854,0.62,Vattiyoorkavu
1,Krishnakumar G,Bharatiya Janata Party,34371,625,34996,27.29,Thiruvananthapuram
2,V .S .Sivakumar,Indian National Congress,40804,855,41659,32.49,Thiruvananthapuram
3,Adv.Antony Raju,Janadhipathiya Kerala Congress,47950,798,48748,38.01,Thiruvananthapuram
4,A .Saboora,SOCIALIST UNITY CENTRE OF INDIA (COMMUNIST),356,10,366,0.29,Thiruvananthapuram
5,Abhilash Vadakkan,Independent,433,3,436,0.34,Thiruvananthapuram
6,Antony Raju S/O Raju,Independent,185,5,190,0.15,Thiruvananthapuram
7,Krishnakumar T .S S/O Sankarankutty,Independent,87,2,89,0.07,Thiruvananthapuram
8,Chala Mohanan D,Independent,238,7,245,0.19,Thiruvananthapuram
9,Raju Antony,Independent,281,8,289,0.23,Thiruvananthapuram
10,Sivakumar. K S/O Kumara Swamy,Independent,161,3,164,0.13,Thiruvananthapuram
11,Nota,None of the Above,1034,20,1054,0.82,Thiruvananthapuram
1,Kummanam Rajasekharan,Bharatiya Janata Party,50856,1032,51888,35.54,Nemom
2,K.Muraleedharan,Indian National Congress,35532,992,36524,25.01,Nemom
3,D.Vijayan,Bahujan Samaj Party,352,4,356,0.24,Nemom
4,V.Sivankutty,Communist Party of India (Marxist),54452,1385,55837,38.24,Nemom
5,Jain Wilson,Independent,164,1,165,0.11,Nemom
6,Balachandran Valkannadi,Independent,84,1,85,0.06,Nemom
7,Muraleedharan Nair,Independent,46,2,48,0.03,Nemom
8,Rajasekharan,Independent,46,4,50,0.03,Nemom
9,Arampally Vijayaraj,Independent,136,2,138,0.09,Nemom
10,Shine Raj.B,Independent,65,5,70,0.05,Nemom
11,L Sathyan Nadar,Independent,100,0,100,0.07,Nemom
12,Nota,None of the Above,749,7,756,0.52,Nemom
1,Krishnankutty. M,Bahujan Samaj Party,904,19,923,0.63,Aruvikkara
2,K. S. Sabarinadhan,Indian National Congress,59877,1853,61730,42.37,Aruvikkara
3,C. Sivankutty,Bharatiya Janata Party,15060,319,15379,10.55,Aruvikkara
4,Adv. G. Steephen,Communist Party of India (Marxist),64795,1981,66776,45.83,Aruvikkara
5,Nota,None of the Above,885,15,900,0.62,Aruvikkara
1,An Sajitha Ressal.R.K,Indian National Congress,51273,1447,52720,32.33,Parassala
2,J.R.Jayakumar,Bahujan Samaj Party,775,3,778,0.48,Parassala
3,Karamana Jayan,Bharatiya Janata Party,29195,655,29850,18.3,Parassala
4,C.K.Hareendran,Communist Party of India (Marxist),76302,2246,78548,48.16,Parassala
5,Shaju Paliyodu,Independent,400,2,402,0.25,Parassala
6,Selvaraj.J.R,Independent,159,3,162,0.1,Parassala
7,Nota,None of the Above,623,7,630,0.39,Parassala
1,P.K Krishnadas,Bharatiya Janata Party,33755,787,34542,23.72,Kattakkada
2,Malayinkeezhu Venugopal,Indian National Congress,41723,1339,43062,29.57,Kattakkada
3,Adv I B Satheesh,Communist Party of India (Marxist),64159,2134,66293,45.52,Kattakkada
4,Kandala Suresh,Bahujan Samaj Party,623,5,628,0.43,Kattakkada
5,Sreekala Nadar,Independent,256,10,266,0.18,Kattakkada
6,Syriac Damian V. P,Independent,126,3,129,0.09,Kattakkada
7,Nota,None of the Above,686,13,699,0.48,Kattakkada
1,Vishnupuram Chandrasekharan,Bharatiya Janata Party,18267,397,18664,11.73,Kovalam
2,Neelalohithadasan Nadar,Janata Dal (Secular),61582,1724,63306,39.79,Kovalam
3,Adv. M. Vincent,Indian National Congress,72676,2192,74868,47.06,Kovalam
4,Kanchampazhinji Sasikumar,Bahujan Samaj Party,635,6,641,0.4,Kovalam
5,Ajil R.A.,Independent,141,6,147,0.09,Kovalam
6,Venganoor Asokan,Independent,268,16,284,0.18,Kovalam
7,Prince V.S.,Independent,402,15,417,0.26,Kovalam
8,Nota,None of the Above,758,15,773,0.49,Kovalam
1,K. Ansalan,Communist Party of India (Marxist),63345,2152,65497,47.02,Neyyattinkara
2,Premakumar. T. R,Bahujan Samaj Party,626,17,643,0.46,Neyyattinkara
3,Chenkal. S. Rajasekharan Nair,Bharatiya Janata Party,20475,534,21009,15.08,Neyyattinkara
4,Selvaraj. R,Indian National Congress,49451,1784,51235,36.78,Neyyattinkara
5,Nota,None of the Above,892,15,907,0.65,Neyyattinkara
